GEO_ID_long,GEO_ID,STATEFIP,COUNTYFIP,CountyNAME,TotalPopulation_2010,Hispanic_2010,NonHispanic_2010,PopulationofOneRace_2010,Whitealone_2010,Blackalon_2010,AIANalone_2010,Asianalone_2010,NativeHawaiianPIalone_2010,SomeOtherRace_2010,Mixed_2010,DiversityIndex2010,GEOID,NAME,TotalPopulation_2020,Hispanic_2020,NonHispanic_2020,PopulationofOneRace_2020,Whitealone_2020,Blackalon_2020,AIANalone_2020,Asianalone_2020,NativeHawaiianPIalone_2020,SomeOtherRace_2020,Mixed_2020,DiversityIndex2020,ChangeDiversityIndex,RateChangeDiversityIndex,ChangeDiversityIndexPercent,RateChangeDiversityIndexPercent
0500000US01001,01001,1,1,"Autauga County, Alabama",54571,1310,53261,52500,42154,9595,217,467,22,45,761,0.372,0500000US01001,Autauga County,58805,2117,56688,54198,41582,11352,184,873,22,185,2490,0.459,0.088,0.236,8.8%,23.6%
0500000US01003,01003,1,3,"Baldwin County, Alabama",182265,7992,174273,171976,152200,16966,1146,1340,79,245,2297,0.292,0500000US01003,Baldwin County,231767,12686,219081,208713,186495,18001,1291,2029,122,775,10368,0.341,0.050,0.170,5.0%,17.0%
0500000US01005,01005,1,5,"Barbour County, Alabama",27457,1387,26070,25861,12837,12820,60,107,24,13,209,0.561,0500000US01005,Barbour County,25223,1510,23713,23160,11086,11850,58,103,0,63,553,0.582,0.021,0.038,2.1%,3.8%
0500000US01007,01007,1,7,"Bibb County, Alabama",22915,406,22509,22328,17191,5024,64,22,7,20,181,0.389,0500000US01007,Bibb County,22293,740,21553,20953,16442,4390,39,26,9,47,600,0.415,0.027,0.069,2.7%,6.9%
0500000US01009,01009,1,9,"Blount County, Alabama",57322,4626,52696,52129,50952,724,285,115,18,35,567,0.203,0500000US01009,Blount County,59134,5771,53363,51063,49764,826,188,174,11,100,2300,0.281,0.077,0.381,7.7%,38.1%
0500000US01011,01011,1,11,"Bullock County, Alabama",10914,777,10137,10078,2392,7637,20,20,4,5,59,0.457,0500000US01011,Bullock County,10357,503,9854,9717,2281,7388,1,9,7,31,137,0.440,-0.017,-0.037,-1.7%,-3.7%
0500000US01013,01013,1,13,"Butler County, Alabama",20947,191,20756,20614,11324,9047,59,174,7,3,142,0.521,0500000US01013,Butler County,19051,260,18791,18285,9679,8389,23,143,5,46,506,0.547,0.026,0.050,2.6%,5.0%
0500000US01015,01015,1,15,"Calhoun County, Alabama",118572,3893,114679,112975,87285,24177,480,830,94,109,1704,0.415,0500000US01015,Calhoun County,116441,5010,111431,106863,79519,25365,386,1164,112,317,4568,0.483,0.067,0.163,6.7%,16.3%
0500000US01017,01017,1,17,"Chambers County, Alabama",34215,536,33679,33352,19893,13206,57,166,7,23,327,0.513,0500000US01017,Chambers County,34772,1237,33535,32639,18616,13441,71,385,11,115,896,0.562,0.049,0.096,4.9%,9.6%
0500000US01019,01019,1,19,"Cherokee County, Alabama",25989,320,25669,25322,23929,1206,122,49,1,15,347,0.150,0500000US01019,Cherokee County,24971,400,24571,23761,22563,987,109,55,1,46,810,0.181,0.031,0.207,3.1%,20.7%
0500000US01021,01021,1,21,"Chilton County, Alabama",43643,3420,40223,39870,35395,4171,134,125,11,34,353,0.327,0500000US01021,Chilton County,45014,4418,40596,39332,34878,4040,112,176,5,121,1264,0.381,0.054,0.166,5.4%,16.6%
0500000US01023,01023,1,23,"Choctaw County, Alabama",13859,73,13786,13730,7700,5990,18,12,0,10,56,0.504,0500000US01023,Choctaw County,12665,113,12552,12312,7039,5217,24,19,0,13,240,0.521,0.017,0.033,1.7%,3.3%
0500000US01025,01025,1,25,"Clarke County, Alabama",25833,271,25562,25406,13943,11280,96,74,4,9,156,0.518,0500000US01025,Clarke County,23087,206,22881,22396,11970,10223,74,91,1,37,485,0.535,0.017,0.032,1.7%,3.2%
0500000US01027,01027,1,27,"Clay County, Alabama",13932,399,13533,13317,11186,2048,55,23,0,5,216,0.333,0500000US01027,Clay County,14236,449,13787,13324,11261,1942,45,46,4,26,463,0.354,0.021,0.063,2.1%,6.3%
0500000US01029,01029,1,29,"Cleburne County, Alabama",14972,307,14665,14528,13956,494,50,23,1,4,137,0.130,0500000US01029,Cleburne County,15056,284,14772,14278,13740,457,42,21,2,16,494,0.165,0.035,0.273,3.5%,27.3%
0500000US01031,01031,1,31,"Coffee County, Alabama",49948,3180,46768,45725,36134,8257,602,629,51,52,1043,0.445,0500000US01031,Coffee County,53465,4887,48578,45951,35759,8643,405,892,57,195,2627,0.515,0.071,0.159,7.1%,15.9%
0500000US01033,01033,1,33,"Colbert County, Alabama",54428,1093,53335,52571,43334,8702,262,224,14,35,764,0.340,0500000US01033,Colbert County,57227,1732,55495,53262,43241,9222,223,432,9,135,2233,0.401,0.061,0.178,6.1%,17.8%
0500000US01035,01035,1,35,"Conecuh County, Alabama",13228,161,13067,12953,6764,6122,44,17,0,6,114,0.524,0500000US01035,Conecuh County,11597,256,11341,11051,5835,5096,71,33,0,16,290,0.553,0.028,0.054,2.8%,5.4%
0500000US01037,01037,1,37,"Coosa County, Alabama",11539,230,11309,11221,7604,3556,40,14,0,7,88,0.470,0500000US01037,Coosa County,10387,201,10186,9887,6807,3000,25,8,0,47,299,0.486,0.016,0.033,1.6%,3.3%
0500000US01039,01039,1,39,"Covington County, Alabama",37765,483,37282,36794,31751,4685,196,148,1,13,488,0.277,0500000US01039,Covington County,37570,654,36916,35671,30657,4563,140,240,0,71,1245,0.318,0.041,0.146,4.1%,14.6%
0500000US01041,01041,1,41,"Crenshaw County, Alabama",13906,204,13702,13509,10020,3241,56,189,1,2,193,0.426,0500000US01041,Crenshaw County,13194,187,13007,12578,9333,3085,48,83,2,27,429,0.444,0.018,0.042,1.8%,4.2%
0500000US01043,01043,1,43,"Cullman County, Alabama",80406,3454,76952,76184,74568,821,397,339,18,41,768,0.138,0500000US01043,Cullman County,87866,4146,83720,80236,78298,914,287,522,64,151,3484,0.202,0.064,0.465,6.4%,46.5%
0500000US01045,01045,1,45,"Dale County, Alabama",50251,2821,47430,46223,35705,9546,337,527,42,66,1207,0.455,0500000US01045,Dale County,49326,3254,46072,43773,32602,10100,217,648,42,164,2299,0.514,0.059,0.130,5.9%,13.0%
0500000US01047,01047,1,47,"Dallas County, Alabama",43820,309,43511,43233,12676,30314,78,144,6,15,278,0.438,0500000US01047,Dallas County,38462,296,38166,37426,10363,26812,56,145,12,38,740,0.441,0.003,0.008,0.3%,0.8%
0500000US01049,01049,1,49,"DeKalb County, Alabama",71109,9690,61419,60133,57997,1029,865,166,35,41,1286,0.316,0500000US01049,DeKalb County,71608,11744,59864,56602,54529,1019,715,237,16,86,3262,0.391,0.075,0.239,7.5%,23.9%
0500000US01051,01051,1,51,"Elmore County, Alabama",79303,2129,77174,76170,59449,15814,269,514,50,74,1004,0.397,0500000US01051,Elmore County,87977,2793,85184,81908,62540,18126,270,669,28,275,3276,0.450,0.052,0.132,5.2%,13.2%
0500000US01053,01053,1,53,"Escambia County, Alabama",38319,718,37601,37062,23508,12162,1274,86,12,20,539,0.521,0500000US01053,Escambia County,36757,751,36006,34593,22004,10922,1488,108,22,49,1413,0.550,0.029,0.055,2.9%,5.5%
0500000US01055,01055,1,55,"Etowah County, Alabama",104430,3447,100983,99651,82789,15716,372,657,30,87,1332,0.348,0500000US01055,Etowah County,103436,4895,98541,94282,77731,14999,332,921,39,260,4259,0.410,0.063,0.180,6.3%,18.0%
0500000US01057,01057,1,57,"Fayette County, Alabama",17241,204,17037,16885,14832,1958,47,37,0,11,152,0.247,0500000US01057,Fayette County,16321,396,15925,15394,13552,1720,43,49,1,29,531,0.298,0.051,0.206,5.1%,20.6%
0500000US01059,01059,1,59,"Franklin County, Alabama",31704,4710,26994,26666,25249,1211,121,51,2,32,328,0.342,0500000US01059,Franklin County,32113,6259,25854,24994,23581,1139,128,67,2,77,860,0.421,0.079,0.230,7.9%,23.0%
0500000US01061,01061,1,61,"Geneva County, Alabama",26790,920,25870,25499,22692,2523,197,64,8,15,371,0.272,0500000US01061,Geneva County,26659,1296,25363,24216,21654,2231,166,86,7,72,1147,0.329,0.057,0.208,5.7%,20.8%
0500000US01063,01063,1,63,"Greene County, Alabama",9045,69,8976,8937,1562,7349,11,15,0,0,39,0.310,0500000US01063,Greene County,7730,61,7669,7535,1285,6227,5,7,0,11,134,0.323,0.013,0.042,1.3%,4.2%
0500000US01065,01065,1,65,"Hale County, Alabama",15760,140,15620,15544,6213,9265,23,35,1,7,76,0.499,0500000US01065,Hale County,14785,149,14636,14365,5972,8313,34,18,5,23,271,0.520,0.021,0.043,2.1%,4.3%
0500000US01067,01067,1,67,"Henry County, Alabama",17302,389,16913,16752,11731,4915,54,45,2,5,161,0.459,0500000US01067,Henry County,17146,334,16812,16246,11842,4232,50,73,0,49,566,0.461,0.002,0.003,0.2%,0.3%
0500000US01069,01069,1,69,"Houston County, Alabama",101547,2995,98552,97107,69731,26038,393,806,43,96,1445,0.462,0500000US01069,Houston County,107202,4481,102721,98477,68251,28232,321,1260,59,354,4244,0.522,0.060,0.131,6.0%,13.1%
0500000US01071,01071,1,71,"Jackson County, Alabama",53227,1339,51888,50606,47937,1771,680,165,29,24,1282,0.186,0500000US01071,Jackson County,52579,1681,50898,47752,45123,1624,680,214,2,109,3146,0.258,0.071,0.383,7.1%,38.3%
0500000US01073,01073,1,73,"Jefferson County, Alabama",658466,25488,632978,626925,340213,275511,1431,9085,154,531,6053,0.556,0500000US01073,Jefferson County,674721,34856,639865,620891,324252,280112,1207,13043,311,1966,18974,0.593,0.037,0.066,3.7%,6.6%
0500000US01075,01075,1,75,"Lamar County, Alabama",14564,180,14384,14210,12542,1635,24,4,1,4,174,0.245,0500000US01075,Lamar County,13972,208,13764,13404,11924,1421,28,6,3,22,360,0.260,0.015,0.061,1.5%,6.1%
0500000US01077,01077,1,77,"Lauderdale County, Alabama",92709,2082,90627,89479,79228,9190,323,675,23,40,1148,0.259,0500000US01077,Lauderdale County,93564,3078,90486,86933,76491,9164,295,748,31,204,3553,0.319,0.060,0.233,6.0%,23.3%
0500000US01079,01079,1,79,"Lawrence County, Alabama",34339,574,33765,32336,26420,3917,1928,41,5,25,1429,0.390,0500000US01079,Lawrence County,33073,895,32178,29616,24714,3302,1440,84,7,69,2562,0.423,0.033,0.085,3.3%,8.5%
0500000US01081,01081,1,81,"Lee County, Alabama",140247,4571,135676,133816,97900,31674,397,3615,66,164,1860,0.460,0500000US01081,Lee County,174241,9135,165106,158526,109795,39252,365,8544,108,462,6580,0.546,0.086,0.187,8.6%,18.7%
0500000US01083,01083,1,83,"Limestone County, Alabama",82782,4591,78191,76969,65112,10350,487,911,26,83,1222,0.362,0500000US01083,Limestone County,103570,7248,96322,91573,75692,13177,458,1857,70,319,4749,0.442,0.080,0.221,8.0%,22.1%
0500000US01085,01085,1,85,"Lowndes County, Alabama",11299,87,11212,11167,2841,8283,25,14,0,4,45,0.399,0500000US01085,Lowndes County,10311,140,10171,9985,2807,7149,9,15,0,5,186,0.445,0.045,0.114,4.5%,11.4%
0500000US01087,01087,1,87,"Macon County, Alabama",21452,232,21220,21016,3267,17631,28,76,2,12,204,0.301,0500000US01087,Macon County,19532,361,19171,18753,3187,15395,48,74,4,45,418,0.351,0.050,0.167,5.0%,16.7%
0500000US01089,01089,1,89,"Madison County, Alabama",334811,15404,319407,312256,221445,79517,2335,8167,321,471,7151,0.503,0500000US01089,Madison County,388153,24936,363217,343039,237497,91079,2132,10179,450,1702,20178,0.563,0.060,0.119,6.0%,11.9%
0500000US01091,01091,1,91,"Marengo County, Alabama",21027,352,20675,20539,9607,10838,31,53,9,1,136,0.525,0500000US01091,Marengo County,19323,368,18955,18610,8375,10133,6,54,1,41,345,0.536,0.011,0.021,1.1%,2.1%
0500000US01093,01093,1,93,"Marion County, Alabama",30776,632,30144,29865,28509,1178,94,53,7,24,279,0.140,0500000US01093,Marion County,29341,863,28478,27401,26093,1094,82,75,14,43,1077,0.206,0.066,0.469,6.6%,46.9%
0500000US01095,01095,1,95,"Marshall County, Alabama",93019,11238,81781,80620,78060,1389,570,475,63,63,1161,0.281,0500000US01095,Marshall County,97612,15658,81954,78283,74666,2293,418,579,128,199,3671,0.387,0.106,0.379,10.6%,37.9%
0500000US01097,01097,1,97,"Mobile County, Alabama",412992,9936,403056,397809,243904,142272,3541,7507,157,428,5247,0.531,0500000US01097,Mobile County,414809,13425,401384,385914,226703,145435,3743,8515,216,1302,15470,0.575,0.044,0.083,4.4%,8.3%
0500000US01099,01099,1,99,"Monroe County, Alabama",23068,220,22848,22537,12621,9581,256,67,4,8,311,0.528,0500000US01099,Monroe County,19772,207,19565,19000,10334,8253,281,88,0,44,565,0.551,0.024,0.045,2.4%,4.5%
0500000US01101,01101,1,101,"Montgomery County, Alabama",229363,8314,221049,218610,88099,124928,520,4792,84,187,2439,0.554,0500000US01101,Montgomery County,228954,10684,218270,212312,73354,129801,364,7952,119,722,5958,0.572,0.018,0.032,1.8%,3.2%
0500000US01103,01103,1,103,"Morgan County, Alabama",119490,9156,110334,108386,92585,14059,928,665,69,80,1948,0.380,0500000US01103,Morgan County,123421,12377,111044,105460,88238,15307,631,829,79,376,5584,0.461,0.082,0.215,8.2%,21.5%
0500000US01105,01105,1,105,"Perry County, Alabama",10591,114,10477,10442,3142,7244,17,30,5,4,35,0.444,0500000US01105,Perry County,8511,89,8422,8285,2345,5914,15,10,1,0,137,0.441,-0.003,-0.007,-0.3%,-0.7%
0500000US01107,01107,1,107,"Pickens County, Alabama",19746,313,19433,19275,11027,8169,28,32,1,18,158,0.517,0500000US01107,Pickens County,19123,1053,18070,17627,10066,7448,23,78,0,12,443,0.568,0.051,0.099,5.1%,9.9%
0500000US01109,01109,1,109,"Pike County, Alabama",32899,730,32169,31727,18887,11990,185,645,6,14,442,0.537,0500000US01109,Pike County,33009,905,32104,30976,18036,12068,169,577,9,117,1128,0.566,0.029,0.054,2.9%,5.4%
0500000US01111,01111,1,111,"Randolph County, Alabama",22913,649,22264,22035,17280,4604,84,54,5,8,229,0.390,0500000US01111,Randolph County,21967,605,21362,20631,16629,3814,50,86,1,51,731,0.395,0.005,0.013,0.5%,1.3%
0500000US01113,01113,1,113,"Russell County, Alabama",52947,1946,51001,50096,27591,21926,189,223,112,55,905,0.555,0500000US01113,Russell County,59183,3195,55988,53559,26679,25930,180,408,128,234,2429,0.600,0.045,0.081,4.5%,8.1%
0500000US01115,01115,1,115,"St. Clair County, Alabama",83593,1716,81877,80914,72947,7098,252,512,41,64,963,0.231,0500000US01115,St. Clair County,91103,2575,88528,84737,74962,8617,249,655,20,234,3791,0.311,0.081,0.350,8.1%,35.0%
0500000US01117,01117,1,117,"Shelby County, Alabama",195085,11567,183518,181446,156371,20606,458,3699,62,250,2072,0.342,0500000US01117,Shelby County,223024,16460,206564,197904,162712,28711,478,5114,91,798,8660,0.444,0.101,0.296,10.1%,29.6%
0500000US01119,01119,1,119,"Sumter County, Alabama",13763,86,13677,13632,3304,10283,11,33,1,0,45,0.384,0500000US01119,Sumter County,12345,131,12214,12032,2937,8955,26,102,3,9,182,0.417,0.033,0.085,3.3%,8.5%
0500000US01121,01121,1,121,"Talladega County, Alabama",82291,1671,80620,79657,53079,25953,230,329,6,60,963,0.484,0500000US01121,Talladega County,82149,1779,80370,77884,50732,26340,184,395,27,206,2486,0.514,0.030,0.063,3.0%,6.3%
0500000US01123,01123,1,123,"Tallapoosa County, Alabama",41616,1042,40574,40228,28838,11050,119,197,2,22,346,0.449,0500000US01123,Tallapoosa County,41311,1144,40167,39015,28252,10366,84,222,0,91,1152,0.468,0.019,0.043,1.9%,4.3%
0500000US01125,01125,1,125,"Tuscaloosa County, Alabama",194656,5949,188707,186972,126611,57401,455,2293,76,136,1735,0.489,0500000US01125,Tuscaloosa County,227036,12298,214738,208206,134880,68779,420,3241,94,792,6532,0.551,0.062,0.128,6.2%,12.8%
0500000US01127,01127,1,127,"Walker County, Alabama",67023,1307,65716,64957,60587,3885,233,190,26,36,759,0.179,0500000US01127,Walker County,65342,2152,63190,60891,56394,3889,187,283,2,136,2299,0.249,0.070,0.393,7.0%,39.3%
0500000US01129,01129,1,129,"Washington County, Alabama",17581,151,17430,17244,11455,4360,1394,18,9,8,186,0.507,0500000US01129,Washington County,15388,138,15250,14726,10267,3318,1102,14,2,23,524,0.502,-0.006,-0.011,-0.6%,-1.1%
0500000US01131,01131,1,131,"Wilcox County, Alabama",11670,72,11598,11551,3110,8420,14,4,1,2,47,0.408,0500000US01131,Wilcox County,10600,112,10488,10330,2866,7425,11,7,5,16,158,0.436,0.028,0.067,2.8%,6.7%
0500000US01133,01133,1,133,"Winston County, Alabama",24484,639,23845,23562,23237,115,139,59,8,4,283,0.098,0500000US01133,Winston County,23540,815,22725,21918,21598,131,83,58,9,39,807,0.156,0.057,0.583,5.7%,58.3%
0500000US02013,02013,2,13,"Aleutians East Borough, Alaska",3141,385,2756,2639,425,212,869,1113,19,1,117,0.759,0500000US02013,Aleutians East Borough,3420,674,2746,2566,658,297,797,771,32,11,180,0.809,0.050,0.066,5.0%,6.6%
0500000US02016,02016,2,16,"Aleutians West Census Area, Alaska",5561,726,4835,4586,1745,318,841,1575,102,5,249,0.776,0500000US02016,Aleutians West Census Area,5232,668,4564,4301,1585,257,709,1502,238,10,263,0.784,0.008,0.011,0.8%,1.1%
0500000US02020,02020,2,20,"Anchorage Municipality, Alaska",291826,22061,269765,249715,182814,15308,22047,23208,5776,562,20050,0.582,0500000US02020,Anchorage Municipality,291247,26438,264809,233536,158232,13777,22480,27281,9844,1922,31273,0.667,0.085,0.146,8.5%,14.6%
0500000US02050,02050,2,50,"Bethel Census Area, Alaska",17013,181,16832,16157,1854,65,14056,158,18,6,675,0.304,0500000US02050,Bethel Census Area,18666,207,18459,17514,1628,84,15580,201,2,19,945,0.293,-0.011,-0.036,-1.1%,-3.6%
0500000US02060,02060,2,60,"Bristol Bay Borough, Alaska",997,24,973,817,476,0,330,8,3,0,156,0.637,0500000US02060,Bristol Bay Borough,844,45,799,669,357,6,296,5,3,2,130,0.671,0.034,0.053,3.4%,5.3%
0500000US02068,02068,2,68,"Denali Borough, Alaska",1826,42,1784,1713,1614,10,64,19,1,5,71,0.215,0500000US02068,Denali Borough,1619,32,1587,1466,1378,9,59,13,3,4,121,0.268,0.053,0.245,5.3%,24.5%
0500000US02070,02070,2,70,"Dillingham Census Area, Alaska",4847,101,4746,4336,855,11,3431,32,6,1,410,0.460,0500000US02070,Dillingham Census Area,4857,146,4711,4262,770,19,3412,45,9,7,449,0.472,0.012,0.025,1.2%,2.5%
0500000US02090,02090,2,90,"Fairbanks North Star Borough, Alaska",97581,5651,91930,86160,72259,4154,6669,2512,375,191,5770,0.438,0500000US02090,Fairbanks North Star Borough,95655,7320,88335,78708,63178,3804,7299,3031,584,812,9627,0.539,0.102,0.232,10.2%,23.2%
0500000US02100,02100,2,100,"Haines Borough, Alaska",2508,47,2461,2324,2062,9,227,13,0,13,137,0.312,0500000US02100,Haines Borough,2080,67,2013,1809,1577,2,205,14,2,9,204,0.405,0.092,0.295,9.2%,29.5%
0500000US02105,02105,2,105,"Hoonah-Angoon Census Area, Alaska",2150,77,2073,1864,993,8,850,12,1,0,209,0.620,0500000US02105,Hoonah-Angoon Census Area,2365,120,2245,2005,1123,6,841,15,4,16,240,0.635,0.015,0.025,1.5%,2.5%
0500000US02110,02110,2,110,"Juneau City and Borough, Alaska",31275,1588,29687,26990,21065,259,3534,1879,213,40,2697,0.520,0500000US02110,Juneau City and Borough,32255,2077,30178,26136,19673,328,3397,2086,469,183,4042,0.593,0.073,0.140,7.3%,14.0%
0500000US02122,02122,2,122,"Kenai Peninsula Borough, Alaska",55400,1641,53759,50901,45879,248,3970,614,111,79,2858,0.305,0500000US02122,Kenai Peninsula Borough,58799,2328,56471,51352,45546,361,4107,793,173,372,5119,0.386,0.080,0.263,8.0%,26.3%
0500000US02130,02130,2,130,"Ketchikan Gateway Borough, Alaska",13477,538,12939,11799,8918,76,1831,936,24,14,1140,0.530,0500000US02130,Ketchikan Gateway Borough,13948,650,13298,11822,8221,100,2264,1118,26,93,1476,0.606,0.076,0.144,7.6%,14.4%
0500000US02150,02150,2,150,"Kodiak Island Borough, Alaska",13592,996,12596,11701,7137,85,1759,2620,86,14,895,0.661,0500000US02150,Kodiak Island Borough,13101,1024,12077,11097,6291,85,1759,2781,107,74,980,0.694,0.034,0.051,3.4%,5.1%
0500000US02158,02158,2,158,Kusilvak (Wade Hampton) Census Area,7459,7,7452,7302,199,1,7082,17,0,3,150,0.097,0500000US02158,Kusilvak (Wade Hampton) Census Area,8368,14,8354,8172,173,16,7946,23,0,14,182,0.097,0.000,0.000,0.0%,0.0%
0500000US02164,02164,2,164,"Lake and Peninsula Borough, Alaska",1631,43,1588,1426,362,9,1044,6,5,0,162,0.530,0500000US02164,Lake and Peninsula Borough,1476,34,1442,1298,297,1,993,7,0,0,144,0.497,-0.034,-0.063,-3.4%,-6.3%
0500000US02170,02170,2,170,"Matanuska-Susitna Borough, Alaska",88995,3301,85694,80638,73676,817,4735,1075,214,121,5056,0.307,0500000US02170,Matanuska-Susitna Borough,107081,5244,101837,91416,81050,1059,6531,1515,476,785,10421,0.411,0.104,0.339,10.4%,33.9%
0500000US02180,02180,2,180,"Nome Census Area, Alaska",9492,115,9377,8818,1511,27,7175,88,9,8,559,0.400,0500000US02180,Nome Census Area,10046,186,9860,9092,1393,52,7508,109,5,25,768,0.416,0.016,0.041,1.6%,4.1%
0500000US02185,02185,2,185,"North Slope Borough, Alaska",9430,249,9181,8720,3059,91,5046,414,103,7,461,0.603,0500000US02185,North Slope Borough,11031,548,10483,9790,2964,159,5680,636,321,30,693,0.652,0.049,0.081,4.9%,8.1%
0500000US02188,02188,2,188,"Northwest Arctic Borough, Alaska",7523,58,7465,7024,830,35,6102,42,12,3,441,0.326,0500000US02188,Northwest Arctic Borough,7793,102,7691,7272,684,71,6453,53,11,0,419,0.303,-0.023,-0.070,-2.3%,-7.0%
0500000US02195,02195,2,195,"Petersburg Census Area, Alaska",3815,130,3685,3382,2649,15,603,96,6,13,303,0.485,0500000US02195,Petersburg Borough,3398,164,3234,2871,2444,46,231,117,12,21,363,0.463,-0.022,-0.045,-2.2%,-4.5%
0500000US02198,02198,2,198,"Prince of Wales-Hyder Census Area, Alaska",5559,127,5432,4984,2756,17,2165,21,21,4,448,0.595,0500000US02198,Prince of Wales-Hyder Census Area,5753,160,5593,4989,2368,21,2529,25,30,16,604,0.625,0.030,0.050,3.0%,5.0%
0500000US02220,02220,2,220,"Sitka City and Borough, Alaska",8881,437,8444,7675,5641,43,1442,509,29,11,769,0.557,0500000US02220,Sitka City and Borough,8458,501,7957,6933,5050,37,1206,573,14,53,1024,0.600,0.043,0.078,4.3%,7.8%
0500000US02230,02230,2,230,"Skagway Municipality, Alaska",968,21,947,912,872,0,34,5,1,0,35,0.185,0500000US02230,Skagway Municipality,1240,41,1199,1130,1056,6,23,39,0,6,69,0.269,0.084,0.451,8.4%,45.1%
0500000US02240,02240,2,240,"Southeast Fairbanks Census Area, Alaska",7029,234,6795,6484,5535,71,797,64,11,6,311,0.364,0500000US02240,Southeast Fairbanks Census Area,6808,376,6432,5979,4993,68,795,87,13,23,453,0.441,0.077,0.211,7.7%,21.1%
0500000US02261,02261,2,261,"Valdez-Cordova Census Area, Alaska",9636,349,9287,8669,6949,45,1270,350,54,1,618,0.456,0500000US02261,"Valdez-Cordova Census Area, Alaska",9719,481,9238,8369,6359,52,1302,544,71,41,869,0.540,0.085,0.185,8.5%,18.5%
0500000US02275,02275,2,275,"Wrangell City and Borough, Alaska",2369,37,2332,2118,1699,4,381,32,1,1,214,0.451,0500000US02275,Wrangell City and Borough,2127,76,2051,1747,1341,0,368,25,2,11,304,0.551,0.100,0.221,10.0%,22.1%
0500000US02282,02282,2,282,"Yakutat City and Borough, Alaska",662,17,645,544,268,2,235,27,12,0,101,0.684,0500000US02282,Yakutat City and Borough,662,29,633,533,248,2,250,32,1,0,100,0.690,0.006,0.008,0.6%,0.8%
0500000US02290,02290,2,290,"Yukon-Koyukuk Census Area, Alaska",5588,66,5522,5216,1218,9,3967,14,6,2,306,0.445,0500000US02290,Yukon-Koyukuk Census Area,5343,72,5271,4972,1121,6,3818,8,3,16,299,0.442,-0.003,-0.007,-0.3%,-0.7%
0500000US04001,04001,4,1,"Apache County, Arizona",71518,4113,67405,66321,14568,157,51360,185,24,27,1084,0.439,0500000US04001,Apache County,66021,3861,62160,60924,13791,184,46509,307,18,115,1236,0.456,0.017,0.039,1.7%,3.9%
0500000US04003,04003,4,3,"Cochise County, Arizona",131346,42543,88803,85742,76805,4936,989,2410,379,223,3061,0.551,0500000US04003,Cochise County,125447,42615,82832,77122,68256,4371,762,2587,421,725,5710,0.585,0.034,0.062,3.4%,6.2%
0500000US04005,04005,4,5,"Coconino County, Arizona",134421,18166,116255,113453,74231,1495,35610,1787,138,192,2802,0.606,0500000US04005,Coconino County,145101,21719,123382,117276,76904,1777,35143,2582,254,616,6106,0.636,0.030,0.049,3.0%,4.9%
0500000US04007,04007,4,7,"Gila County, Arizona",53597,9588,44009,43436,35298,195,7615,256,34,38,573,0.514,0500000US04007,Gila County,53272,9283,43989,42326,32757,239,8655,427,45,203,1663,0.564,0.050,0.098,5.0%,9.8%
0500000US04009,04009,4,9,"Graham County, Arizona",37220,11320,25900,25465,19483,633,5074,193,49,33,435,0.614,0500000US04009,Graham County,38533,11428,27105,26281,20398,453,5143,169,16,102,824,0.613,-0.001,-0.002,-0.1%,-0.2%
0500000US04011,04011,4,11,"Greenlee County, Arizona",8437,4040,4397,4327,4054,79,142,44,5,3,70,0.539,0500000US04011,Greenlee County,9563,4376,5187,4904,4446,80,275,68,1,34,283,0.573,0.033,0.062,3.3%,6.2%
0500000US04012,04012,4,12,"La Paz County, Arizona",20489,4806,15683,15276,12854,115,2201,90,5,11,407,0.539,0500000US04012,La Paz County,16557,4197,12360,11712,9061,102,2354,111,41,43,648,0.614,0.075,0.139,7.5%,13.9%
0500000US04013,04013,4,13,"Maricopa County, Arizona",3817117,1128741,2688376,2617329,2240055,177490,59252,128301,6723,5508,71047,0.564,0500000US04013,Maricopa County,4420568,1351415,3069153,2899345,2357571,245239,68353,197910,9579,20693,169808,0.615,0.051,0.090,5.1%,9.0%
0500000US04015,04015,4,15,"Mohave County, Arizona",200186,29569,170617,167363,159378,1715,3793,2016,316,145,3254,0.344,0500000US04015,Mohave County,213267,34126,179141,169936,160165,2063,4053,2600,365,690,9205,0.408,0.064,0.187,6.4%,18.7%
0500000US04017,04017,4,17,"Navajo County, Arizona",107449,11571,95878,94228,47181,842,45551,542,68,44,1650,0.616,0500000US04017,Navajo County,106717,10887,95830,92880,44786,674,46572,548,68,232,2950,0.622,0.007,0.011,0.7%,1.1%
0500000US04019,04019,4,19,"Pima County, Arizona",980263,338802,641461,623722,541700,31075,23558,24592,1336,1461,17739,0.573,0500000US04019,Pima County,1043433,372788,670645,633230,536868,36254,23670,29844,1937,4657,37415,0.604,0.031,0.054,3.1%,5.4%
0500000US04021,04021,4,21,"Pinal County, Arizona",375770,106977,268793,261993,220486,16007,17410,6114,1489,487,6800,0.570,0500000US04021,Pinal County,425264,121533,303731,286903,240006,20712,17156,6290,1081,1658,16828,0.594,0.024,0.042,2.4%,4.2%
0500000US04023,04023,4,23,"Santa Cruz County, Arizona",47420,39273,8147,8029,7564,89,115,235,7,19,118,0.289,0500000US04023,Santa Cruz County,47669,39632,8037,7745,7119,114,78,271,13,150,292,0.286,-0.002,-0.008,-0.2%,-0.8%
0500000US04025,04025,4,25,"Yavapai County, Arizona",211033,28728,182305,178944,172968,1104,2799,1703,182,188,3361,0.309,0500000US04025,Yavapai County,236209,34390,201819,192172,183296,1415,3319,2802,269,1071,9647,0.375,0.065,0.212,6.5%,21.2%
0500000US04027,04027,4,27,"Yuma County, Arizona",195751,116912,78839,76609,69022,3169,1957,2041,204,216,2230,0.518,0500000US04027,Yuma County,203881,130003,73878,69653,61123,3484,1888,2321,215,622,4225,0.503,-0.016,-0.030,-1.6%,-3.0%
0500000US05001,05001,5,1,"Arkansas County, Arkansas",19019,513,18506,18281,13511,4634,31,92,2,11,225,0.435,0500000US05001,Arkansas County,17149,636,16513,15885,11575,4138,34,94,9,35,628,0.483,0.048,0.111,4.8%,11.1%
0500000US05003,05003,5,3,"Ashley County, Arkansas",21853,1069,20784,20619,14901,5619,53,40,2,4,165,0.466,0500000US05003,Ashley County,19062,1114,17948,17433,12685,4644,25,41,6,32,515,0.494,0.027,0.058,2.7%,5.8%
0500000US05005,05005,5,5,"Baxter County, Arkansas",41513,688,40825,40306,39837,59,217,163,16,14,519,0.079,0500000US05005,Baxter County,41627,1058,40569,38692,38049,88,218,234,9,94,1877,0.162,0.083,1.057,8.3%,105.7%
0500000US05007,05007,5,7,"Benton County, Arkansas",221339,34283,187056,182795,169605,2647,3440,6245,634,224,4261,0.387,0500000US05007,Benton County,284333,50540,233793,217144,191761,4523,3799,13602,2598,861,16649,0.507,0.120,0.310,12.0%,31.0%
0500000US05009,05009,5,9,"Boone County, Arkansas",36903,674,36229,35641,35139,64,247,153,21,17,588,0.093,0500000US05009,Boone County,37373,973,36400,34456,33753,96,265,233,27,82,1944,0.181,0.088,0.952,8.8%,95.2%
0500000US05011,05011,5,11,"Bradley County, Arkansas",11508,1516,9992,9885,6676,3167,15,25,1,1,107,0.570,0500000US05011,Bradley County,10545,1575,8970,8698,5708,2921,29,27,0,13,272,0.607,0.037,0.065,3.7%,6.5%
0500000US05013,05013,5,13,"Calhoun County, Arkansas",5368,152,5216,5152,3939,1190,10,11,0,2,64,0.411,0500000US05013,Calhoun County,4739,127,4612,4433,3499,913,3,5,9,4,179,0.416,0.004,0.010,0.4%,1.0%
0500000US05015,05015,5,15,"Carroll County, Arkansas",27446,3489,23957,23554,23062,74,224,160,16,18,403,0.277,0500000US05015,Carroll County,28260,4306,23954,22606,21175,88,253,564,432,94,1348,0.412,0.135,0.486,13.5%,48.6%
0500000US05017,05017,5,17,"Chicot County, Arkansas",11800,542,11258,11193,4761,6347,23,53,3,6,65,0.546,0500000US05017,Chicot County,10208,581,9627,9372,3887,5387,26,38,9,25,255,0.573,0.027,0.049,2.7%,4.9%
0500000US05019,05019,5,19,"Clark County, Arkansas",22995,926,22069,21776,16177,5366,84,120,5,24,293,0.449,0500000US05019,Clark County,21446,1092,20354,19490,14093,5068,76,150,16,87,864,0.508,0.059,0.132,5.9%,13.2%
0500000US05021,05021,5,21,"Clay County, Arkansas",16083,217,15866,15696,15577,56,40,18,1,4,170,0.062,0500000US05021,Clay County,14552,327,14225,13697,13574,40,44,14,5,20,528,0.128,0.066,1.078,6.6%,107.8%
0500000US05023,05023,5,23,"Cleburne County, Arkansas",25970,517,25453,25149,24894,67,126,51,7,4,304,0.081,0500000US05023,Cleburne County,24711,632,24079,23073,22748,56,112,96,11,50,1006,0.150,0.070,0.864,7.0%,86.4%
0500000US05025,05025,5,25,"Cleveland County, Arkansas",8689,145,8544,8487,7394,1053,23,10,1,6,57,0.261,0500000US05025,Cleveland County,7550,182,7368,7145,6429,675,21,7,1,12,223,0.265,0.005,0.018,0.5%,1.8%
0500000US05027,05027,5,27,"Columbia County, Arkansas",24552,533,24019,23810,14545,9006,62,171,3,23,209,0.514,0500000US05027,Columbia County,22801,773,22028,21375,13236,7834,71,163,0,71,653,0.543,0.029,0.057,2.9%,5.7%
0500000US05029,05029,5,29,"Conway County, Arkansas",21273,757,20516,20146,17533,2376,147,76,4,10,370,0.307,0500000US05029,Conway County,20715,886,19829,18593,16148,2190,136,89,8,22,1236,0.376,0.069,0.225,6.9%,22.5%
0500000US05031,05031,5,31,"Craighead County, Arkansas",96443,4277,92166,90773,76760,12564,283,1068,23,75,1393,0.347,0500000US05031,Craighead County,111231,6727,104504,99754,79137,18331,270,1684,54,278,4750,0.461,0.114,0.327,11.4%,32.7%
0500000US05033,05033,5,33,"Crawford County, Arkansas",61948,3760,58188,56728,53770,696,1331,874,19,38,1460,0.242,0500000US05033,Crawford County,60133,4567,55566,50942,47627,857,1366,939,27,126,4624,0.360,0.118,0.490,11.8%,49.0%
0500000US05035,05035,5,35,"Crittenden County, Arkansas",50902,1014,49888,49423,23028,25953,120,301,6,15,465,0.535,0500000US05035,Crittenden County,48163,1428,46735,45295,18948,25804,115,322,17,89,1440,0.556,0.022,0.040,2.2%,4.0%
0500000US05037,05037,5,37,"Cross County, Arkansas",17870,266,17604,17445,13343,3966,46,83,3,4,159,0.393,0500000US05037,Cross County,16833,352,16481,15906,12067,3651,38,102,5,43,575,0.437,0.045,0.113,4.5%,11.3%
0500000US05039,05039,5,39,"Dallas County, Arkansas",8116,188,7928,7840,4393,3396,32,10,1,8,88,0.531,0500000US05039,Dallas County,6482,201,6281,6053,3425,2582,14,7,0,25,228,0.560,0.029,0.054,2.9%,5.4%
0500000US05041,05041,5,41,"Desha County, Arkansas",13008,578,12430,12344,6083,6176,34,43,2,6,86,0.554,0500000US05041,Desha County,11395,773,10622,10230,4732,5385,36,61,0,16,392,0.598,0.045,0.080,4.5%,8.0%
0500000US05043,05043,5,43,"Drew County, Arkansas",18509,454,18055,17867,12587,5139,42,91,3,5,188,0.460,0500000US05043,Drew County,17350,656,16694,16195,11148,4815,68,100,9,55,499,0.508,0.048,0.105,4.8%,10.5%
0500000US05045,05045,5,45,"Faulkner County, Arkansas",113237,4435,108802,106850,93326,11495,612,1266,42,109,1952,0.308,0500000US05045,Faulkner County,123498,6790,116708,109349,92573,14274,562,1461,61,418,7359,0.418,0.110,0.355,11.0%,35.5%
0500000US05047,05047,5,47,"Franklin County, Arkansas",18125,371,17754,17493,16997,124,183,162,24,3,261,0.120,0500000US05047,Franklin County,17097,491,16606,15680,15201,78,199,162,10,30,926,0.205,0.086,0.716,8.6%,71.6%
0500000US05049,05049,5,49,"Fulton County, Arkansas",12245,97,12148,11957,11805,39,79,28,1,5,191,0.070,0500000US05049,Fulton County,12075,154,11921,11345,11201,27,66,35,0,16,576,0.137,0.067,0.952,6.7%,95.2%
0500000US05051,05051,5,51,"Garland County, Arkansas",96024,4622,91402,89497,80621,7552,532,689,40,63,1905,0.286,0500000US05051,Garland County,100180,7047,93133,87224,77239,8034,623,960,71,297,5909,0.391,0.104,0.365,10.4%,36.5%
0500000US05053,05053,5,53,"Grant County, Arkansas",17853,392,17461,17312,16801,385,75,47,1,3,149,0.113,0500000US05053,Grant County,17958,440,17518,16775,16166,447,70,76,1,15,743,0.187,0.073,0.647,7.3%,64.7%
0500000US05055,05055,5,55,"Greene County, Arkansas",42090,901,41189,40720,40166,232,194,107,7,14,469,0.089,0500000US05055,Greene County,45736,1596,44140,42145,40509,926,138,181,287,104,1995,0.212,0.123,1.389,12.3%,138.9%
0500000US05057,05057,5,57,"Hempstead County, Arkansas",22609,2713,19896,19589,12770,6623,77,82,17,20,307,0.581,0500000US05057,Hempstead County,20065,2953,17112,16420,10558,5644,81,88,5,44,692,0.621,0.041,0.070,4.1%,7.0%
0500000US05059,05059,5,59,"Hot Spring County, Arkansas",32923,919,32004,31510,27703,3544,146,93,12,12,494,0.279,0500000US05059,Hot Spring County,33040,1265,31775,30036,26221,3450,165,114,11,75,1739,0.355,0.076,0.271,7.6%,27.1%
0500000US05061,05061,5,61,"Howard County, Arkansas",13789,1349,12440,12302,9292,2813,94,84,9,10,138,0.495,0500000US05061,Howard County,12785,1517,11268,10777,7982,2626,82,62,4,21,491,0.552,0.058,0.117,5.8%,11.7%
0500000US05063,05063,5,63,"Independence County, Arkansas",36647,2139,34508,34076,32914,709,142,276,19,16,432,0.189,0500000US05063,Independence County,37938,3258,34680,32937,31511,830,133,340,30,93,1743,0.300,0.111,0.585,11.1%,58.5%
0500000US05065,05065,5,65,"Izard County, Arkansas",13696,208,13488,13327,13006,175,102,39,2,3,161,0.098,0500000US05065,Izard County,13577,326,13251,12573,12175,256,73,27,9,33,678,0.192,0.095,0.971,9.5%,97.1%
0500000US05067,05067,5,67,"Jackson County, Arkansas",17997,436,17561,17331,14180,2988,86,53,16,8,230,0.351,0500000US05067,Jackson County,16755,461,16294,15678,12754,2764,43,63,4,50,616,0.391,0.040,0.115,4.0%,11.5%
0500000US05069,05069,5,69,"Jefferson County, Arkansas",77435,1219,76216,75392,32050,42485,201,595,9,52,824,0.527,0500000US05069,Jefferson County,67260,1488,65772,64075,25230,37712,212,664,93,164,1697,0.544,0.016,0.031,1.6%,3.1%
0500000US05071,05071,5,71,"Johnson County, Arkansas",25540,3094,22446,22084,21328,336,209,175,17,19,362,0.287,0500000US05071,Johnson County,25749,3439,22310,21057,19400,454,202,918,27,56,1253,0.410,0.123,0.428,12.3%,42.8%
0500000US05073,05073,5,73,"Lafayette County, Arkansas",7645,131,7514,7459,4583,2837,11,26,0,2,55,0.503,0500000US05073,Lafayette County,6308,145,6163,5985,3870,2043,29,32,5,6,178,0.517,0.015,0.029,1.5%,2.9%
0500000US05075,05075,5,75,"Lawrence County, Arkansas",17415,158,17257,17070,16848,134,61,22,4,1,187,0.064,0500000US05075,Lawrence County,16216,357,15859,15185,14925,138,41,38,10,33,674,0.151,0.087,1.361,8.7%,136.1%
0500000US05077,05077,5,77,"Lee County, Arkansas",10424,168,10256,10143,4320,5740,40,41,2,0,113,0.525,0500000US05077,Lee County,8600,216,8384,8128,3424,4657,18,13,1,15,256,0.547,0.022,0.042,2.2%,4.2%
0500000US05079,05079,5,79,"Lincoln County, Arkansas",14134,452,13682,13568,9296,4211,35,20,1,5,114,0.478,0500000US05079,Lincoln County,12941,619,12322,11914,8188,3650,27,23,9,17,408,0.517,0.039,0.082,3.9%,8.2%
0500000US05081,05081,5,81,"Little River County, Arkansas",13171,357,12814,12579,9831,2508,186,39,2,13,235,0.405,0500000US05081,Little River County,12026,409,11617,10966,8593,2164,161,19,9,20,651,0.453,0.047,0.117,4.7%,11.7%
0500000US05083,05083,5,83,"Logan County, Arkansas",22353,510,21843,21490,20608,285,228,361,4,4,353,0.149,0500000US05083,Logan County,21131,640,20491,19410,18586,225,228,328,8,35,1081,0.222,0.074,0.495,7.4%,49.5%
0500000US05085,05085,5,85,"Lonoke County, Arkansas",68356,2246,66110,65094,60108,4059,329,526,22,50,1016,0.222,0500000US05085,Lonoke County,74015,3610,70405,66197,60596,4349,314,716,49,173,4208,0.321,0.099,0.445,9.9%,44.5%
0500000US05087,05087,5,87,"Madison County, Arkansas",15717,759,14958,14747,14451,27,171,81,11,6,211,0.152,0500000US05087,Madison County,16521,890,15631,14715,14075,36,205,102,238,59,916,0.268,0.116,0.762,11.6%,76.2%
0500000US05089,05089,5,89,"Marion County, Arkansas",16653,287,16366,16135,15963,28,99,37,4,4,231,0.081,0500000US05089,Marion County,16826,379,16447,15631,15414,20,127,56,0,14,816,0.158,0.077,0.958,7.7%,95.8%
0500000US05091,05091,5,91,"Miller County, Arkansas",43462,1038,42424,41806,30691,10589,280,196,17,33,618,0.441,0500000US05091,Miller County,42600,1583,41017,39109,27593,10922,246,205,4,139,1908,0.511,0.070,0.159,7.0%,15.9%
0500000US05093,05093,5,93,"Mississippi County, Arkansas",46480,1695,44785,44250,28106,15761,120,229,1,33,535,0.518,0500000US05093,Mississippi County,40685,1771,38914,37522,22861,14251,67,242,3,98,1392,0.558,0.041,0.078,4.1%,7.8%
0500000US05095,05095,5,95,"Monroe County, Arkansas",8149,132,8017,7933,4549,3314,29,36,0,5,84,0.523,0500000US05095,Monroe County,6799,186,6613,6386,3538,2751,30,28,7,32,227,0.564,0.041,0.078,4.1%,7.8%
0500000US05097,05097,5,97,"Montgomery County, Arkansas",9487,361,9126,8949,8806,17,75,49,2,0,177,0.137,0500000US05097,Montgomery County,8484,415,8069,7670,7499,13,92,47,5,14,399,0.214,0.077,0.567,7.7%,56.7%
0500000US05099,05099,5,99,"Nevada County, Arkansas",8997,220,8777,8671,5861,2758,28,23,1,0,106,0.481,0500000US05099,Nevada County,8310,354,7956,7672,5145,2433,37,41,0,16,284,0.528,0.047,0.098,4.7%,9.8%
0500000US05101,05101,5,101,"Newton County, Arkansas",8330,141,8189,8010,7894,5,84,22,1,4,179,0.101,0500000US05101,Newton County,7225,82,7143,6774,6658,6,66,24,1,19,369,0.148,0.047,0.464,4.7%,46.4%
0500000US05103,05103,5,103,"Ouachita County, Arkansas",26120,408,25712,25339,14706,10434,80,95,4,20,373,0.523,0500000US05103,Ouachita County,22650,516,22134,21170,12092,8856,49,123,3,47,964,0.560,0.037,0.070,3.7%,7.0%
0500000US05105,05105,5,105,"Perry County, Arkansas",10445,247,10198,10056,9779,196,59,17,2,3,142,0.122,0500000US05105,Perry County,10019,286,9733,9256,9069,107,43,12,0,25,477,0.177,0.055,0.450,5.5%,45.0%
0500000US05107,05107,5,107,"Phillips County, Arkansas",21757,287,21470,21293,7535,13652,39,64,1,2,177,0.486,0500000US05107,Phillips County,16568,264,16304,15971,5541,10305,38,64,4,19,333,0.501,0.015,0.030,1.5%,3.0%
0500000US05109,05109,5,109,"Pike County, Arkansas",11291,727,10564,10411,9963,327,63,55,1,2,153,0.216,0500000US05109,Pike County,10171,831,9340,8888,8525,238,83,16,0,26,452,0.288,0.072,0.333,7.2%,33.3%
0500000US05111,05111,5,111,"Poinsett County, Arkansas",24583,543,24040,23760,21881,1764,56,45,4,10,280,0.202,0500000US05111,Poinsett County,22965,829,22136,21134,19163,1773,91,56,1,50,1002,0.295,0.093,0.458,9.3%,45.8%
0500000US05113,05113,5,113,"Polk County, Arkansas",20662,1190,19472,19052,18549,54,348,88,5,8,420,0.190,0500000US05113,Polk County,19221,1278,17943,16629,16092,39,335,100,9,54,1314,0.290,0.100,0.524,10.0%,52.4%
0500000US05115,05115,5,115,"Pope County, Arkansas",61754,4168,57586,56463,53667,1748,397,597,18,36,1123,0.239,0500000US05115,Pope County,63381,6415,56966,53417,50037,2060,456,664,23,177,3549,0.362,0.123,0.516,12.3%,51.6%
0500000US05117,05117,5,117,"Prairie County, Arkansas",8715,81,8634,8562,7470,1061,26,5,0,0,72,0.250,0500000US05117,Prairie County,8282,145,8137,7899,6924,922,19,20,3,11,238,0.288,0.037,0.149,3.7%,14.9%
0500000US05119,05119,5,119,"Pulaski County, Arkansas",382748,22168,360580,354301,211697,133242,1267,7425,155,515,6279,0.569,0500000US05119,Pulaski County,399125,33153,365972,348900,193993,142139,1169,9933,208,1458,17072,0.628,0.059,0.103,5.9%,10.3%
0500000US05121,05121,5,121,"Randolph County, Arkansas",17969,283,17686,17476,17226,128,89,28,4,1,210,0.081,0500000US05121,Randolph County,18571,384,18187,17471,16553,140,84,73,595,26,716,0.202,0.122,1.515,12.2%,151.5%
0500000US05123,05123,5,123,"St. Francis County, Arkansas",28258,1149,27109,26816,11973,14565,127,133,9,9,293,0.553,0500000US05123,St. Francis County,23090,686,22404,21929,9206,12501,65,122,0,35,475,0.547,-0.006,-0.012,-0.6%,-1.2%
0500000US05125,05125,5,125,"Saline County, Arkansas",107118,4087,103031,101754,95298,4945,494,920,15,82,1277,0.205,0500000US05125,Saline County,123416,8507,114909,109472,96745,10351,522,1453,70,331,5437,0.372,0.167,0.816,16.7%,81.6%
0500000US05127,05127,5,127,"Scott County, Arkansas",11233,782,10451,10213,9587,51,190,379,3,3,238,0.265,0500000US05127,Scott County,9836,748,9088,8556,8031,31,183,275,5,31,532,0.323,0.059,0.221,5.9%,22.1%
0500000US05129,05129,5,129,"Searcy County, Arkansas",8195,121,8074,7907,7800,3,91,11,1,1,167,0.093,0500000US05129,Searcy County,7828,140,7688,7202,7092,5,65,20,5,15,486,0.175,0.082,0.875,8.2%,87.5%
0500000US05131,05131,5,131,"Sebastian County, Arkansas",125744,15445,110299,106809,91585,7848,2186,5039,69,82,3490,0.448,0500000US05131,Sebastian County,127799,19328,108471,99145,82785,7891,2379,5700,91,299,9326,0.546,0.098,0.219,9.8%,21.9%
0500000US05133,05133,5,133,"Sevier County, Arkansas",17058,5220,11838,11540,10416,717,324,62,2,19,298,0.531,0500000US05133,Sevier County,15839,5508,10331,9577,8400,550,305,60,241,21,754,0.594,0.063,0.118,6.3%,11.8%
0500000US05135,05135,5,135,"Sharp County, Arkansas",17264,290,16974,16709,16399,91,164,49,2,4,265,0.097,0500000US05135,Sharp County,17271,362,16909,16065,15729,114,121,57,20,24,844,0.168,0.071,0.727,7.1%,72.7%
0500000US05137,05137,5,137,"Stone County, Arkansas",12394,157,12237,12056,11912,11,82,45,3,3,181,0.076,0500000US05137,Stone County,12359,271,12088,11552,11387,21,87,25,2,30,536,0.149,0.073,0.961,7.3%,96.1%
0500000US05139,05139,5,139,"Union County, Arkansas",41639,1460,40179,39748,25722,13674,127,196,11,18,431,0.509,0500000US05139,Union County,39054,1754,37300,36087,22904,12670,108,273,16,116,1213,0.548,0.039,0.076,3.9%,7.6%
0500000US05141,05141,5,141,"Van Buren County, Arkansas",17295,475,16820,16525,16282,65,113,56,2,7,295,0.113,0500000US05141,Van Buren County,15796,501,15295,14571,14319,71,110,56,0,15,724,0.175,0.062,0.555,6.2%,55.5%
0500000US05143,05143,5,143,"Washington County, Arkansas",203065,31458,171607,167227,150546,5828,2154,4372,4100,227,4380,0.424,0500000US05143,Washington County,245871,44755,201116,186433,160566,8330,2443,5631,8734,729,14683,0.534,0.110,0.259,11.0%,25.9%
0500000US05145,05145,5,145,"White County, Arkansas",77076,2879,74197,72968,69026,3033,425,411,30,43,1229,0.195,0500000US05145,White County,76822,3499,73323,69214,64363,3677,319,616,25,214,4109,0.291,0.096,0.493,9.6%,49.3%
0500000US05147,05147,5,147,"Woodruff County, Arkansas",7260,87,7173,7070,5041,1989,17,15,5,3,103,0.442,0500000US05147,Woodruff County,6269,96,6173,5891,4235,1601,8,22,0,25,282,0.476,0.034,0.076,3.4%,7.6%
0500000US05149,05149,5,149,"Yell County, Arkansas",22185,4230,17955,17722,17020,288,127,278,2,7,233,0.375,0500000US05149,Yell County,20263,4204,16059,15289,14710,226,111,202,11,29,770,0.428,0.054,0.143,5.4%,14.3%
0500000US06001,06001,6,1,"Alameda County, California",1510271,339889,1170382,1109520,514559,184126,4189,390524,11931,4191,60862,0.750,0500000US06001,Alameda County,1682353,393749,1288604,1200067,472277,159499,4131,540511,13209,10440,88537,0.751,0.001,0.002,0.1%,0.2%
0500000US06003,06003,6,3,"Alpine County, California",1175,84,1091,1070,852,0,210,7,0,1,21,0.437,0500000US06003,Alpine County,1204,84,1120,1044,801,10,214,12,0,7,76,0.517,0.080,0.183,8.0%,18.3%
0500000US06005,06005,6,5,"Amador County, California",38091,4756,33335,32399,30325,938,547,396,63,130,936,0.349,0500000US06005,Amador County,40474,6014,34460,32393,29725,1215,577,554,73,249,2067,0.435,0.086,0.245,8.6%,24.5%
0500000US06007,06007,6,7,"Butte County, California",220000,31116,188884,181584,165416,3133,3395,8921,401,318,7300,0.411,0500000US06007,Butte County,211632,40112,171520,158046,139651,3320,3050,10333,508,1184,13474,0.522,0.110,0.268,11.0%,26.8%
0500000US06009,06009,6,9,"Calaveras County, California",45578,4703,40875,39623,38074,355,526,529,71,68,1252,0.290,0500000US06009,Calaveras County,45292,5865,39427,36548,34668,334,497,706,75,268,2879,0.393,0.102,0.353,10.2%,35.3%
0500000US06011,06011,6,11,"Colusa County, California",21419,11804,9615,9343,8524,168,296,267,59,29,272,0.537,0500000US06011,Colusa County,21839,13476,8363,7817,6941,182,280,252,70,92,546,0.517,-0.020,-0.037,-2.0%,-3.7%
0500000US06013,06013,6,13,"Contra Costa County, California",1049025,255560,793465,753896,500923,93604,2984,148881,4382,3122,39569,0.683,0500000US06013,Contra Costa County,1165927,314900,851027,784574,455421,97994,2553,214520,5720,8366,66453,0.730,0.047,0.069,4.7%,6.9%
0500000US06015,06015,6,15,"Del Norte County, California",28610,5093,23517,22551,18513,967,1935,938,26,172,966,0.542,0500000US06015,Del Norte County,27743,5321,22422,20215,16262,841,2136,826,28,122,2207,0.606,0.064,0.118,6.4%,11.8%
0500000US06017,06017,6,17,"El Dorado County, California",181058,21875,159183,154260,144689,1296,1553,6143,261,318,4923,0.345,0500000US06017,El Dorado County,191185,26459,164726,153365,140141,1436,1273,9024,276,1215,11361,0.438,0.093,0.269,9.3%,26.9%
0500000US06019,06019,6,19,"Fresno County, California",930450,468070,462380,445172,304522,45005,5979,86856,1066,1744,17208,0.628,0500000US06019,Fresno County,1008654,540743,467911,438365,271889,44295,6074,109665,1233,5209,29546,0.625,-0.003,-0.005,-0.3%,-0.5%
0500000US06021,06021,6,21,"Glenn County, California",28122,10539,17583,17121,15717,192,477,674,22,39,462,0.546,0500000US06021,Glenn County,28917,12541,16376,15377,13897,140,531,626,39,144,999,0.579,0.033,0.060,3.3%,6.0%
0500000US06023,06023,6,23,"Humboldt County, California",134623,13211,121412,115866,103958,1393,6961,2854,332,368,5546,0.389,0500000US06023,Humboldt County,136463,18535,117928,107521,93316,1729,7454,3495,436,1091,10407,0.504,0.115,0.296,11.5%,29.6%
0500000US06025,06025,6,25,"Imperial County, California",174528,140271,34257,33160,23927,5114,1642,2201,87,189,1097,0.334,0500000US06025,Imperial County,179702,153027,26675,25088,16813,3846,1584,2244,82,519,1587,0.265,-0.069,-0.206,-6.9%,-20.6%
0500000US06027,06027,6,27,"Inyo County, California",18546,3597,14949,14558,12296,102,1895,229,15,21,391,0.512,0500000US06027,Inyo County,19016,4399,14617,13682,11035,85,2189,273,13,87,935,0.594,0.082,0.160,8.2%,16.0%
0500000US06029,06029,6,29,"Kern County, California",839631,413033,426598,410631,323794,45377,5893,33100,995,1472,15967,0.604,0500000US06029,Kern County,909235,499158,410077,381514,279600,46776,5197,44257,1127,4557,28563,0.598,-0.006,-0.011,-0.6%,-1.1%
0500000US06031,06031,6,31,"Kings County, California",152982,77866,75116,71860,53879,10314,1297,5339,228,803,3256,0.611,0500000US06031,Kings County,152486,86607,65879,60906,44361,8300,1690,5511,331,713,4973,0.587,-0.023,-0.038,-2.3%,-3.8%
0500000US06033,06033,6,33,"Lake County, California",64665,11088,53577,51553,47938,1186,1530,695,97,107,2024,0.419,0500000US06033,Lake County,68163,15442,52721,48512,44202,1158,1737,940,89,386,4209,0.523,0.104,0.249,10.4%,24.9%
0500000US06035,06035,6,35,"Lassen County, California",34895,6117,28778,27922,23270,2790,999,337,163,363,856,0.517,0500000US06035,Lassen County,32730,7531,25199,23614,19534,2244,939,472,283,142,1585,0.583,0.066,0.128,6.6%,12.8%
0500000US06037,06037,6,37,"Los Angeles County, California",9818605,4687889,5130716,4935795,2728321,815086,18886,1325671,22464,25367,194921,0.669,0500000US06037,Los Angeles County,10014009,4804763,5209246,4896193,2563609,760689,18453,1474237,20522,58683,313053,0.676,0.006,0.010,0.6%,1.0%
0500000US06039,06039,6,39,"Madera County, California",150865,80992,69873,67468,57380,5009,1790,2533,107,649,2405,0.565,0500000US06039,Madera County,156255,93178,63077,58694,48399,4131,1738,3581,122,723,4383,0.546,-0.019,-0.034,-1.9%,-3.4%
0500000US06041,06041,6,41,"Marin County, California",252409,39069,213340,206029,183830,6621,531,13577,436,1034,7311,0.441,0500000US06041,Marin County,262321,49410,212911,198496,173149,6120,555,16175,457,2040,14415,0.521,0.080,0.182,8.0%,18.2%
0500000US06043,06043,6,43,"Mariposa County, California",18251,1676,16575,16029,15192,129,459,201,26,22,546,0.297,0500000US06043,Mariposa County,17131,2140,14991,13769,12838,105,410,287,15,114,1222,0.417,0.120,0.403,12.0%,40.3%
0500000US06045,06045,6,45,"Mendocino County, California",87841,19505,68336,65904,60249,544,3486,1402,92,131,2432,0.478,0500000US06045,Mendocino County,91601,23933,67668,62772,56205,607,3528,1730,110,592,4896,0.550,0.073,0.153,7.3%,15.3%
0500000US06047,06047,6,47,"Merced County, California",255793,140485,115308,110608,81599,8785,1126,18183,476,439,4700,0.590,0500000US06047,Merced County,281202,173857,107345,99767,68729,8191,1164,19824,617,1242,7578,0.551,-0.039,-0.065,-3.9%,-6.5%
0500000US06049,06049,6,49,"Modoc County, California",9686,1342,8344,8124,7649,77,293,70,21,14,220,0.356,0500000US06049,Modoc County,8700,1259,7441,7029,6446,66,387,61,13,56,412,0.426,0.070,0.197,7.0%,19.7%
0500000US06051,06051,6,51,"Mono County, California",14202,3762,10440,10203,9687,42,239,191,11,33,237,0.464,0500000US06051,Mono County,13195,3507,9688,9187,8679,68,177,159,26,78,501,0.495,0.031,0.067,3.1%,6.7%
0500000US06053,06053,6,53,"Monterey County, California",415057,230003,185054,175482,136435,11300,1361,23777,1868,741,9572,0.580,0500000US06053,Monterey County,439035,265321,173714,159594,120077,9051,1314,25123,1859,2170,14120,0.555,-0.025,-0.043,-2.5%,-4.3%
0500000US06055,06055,6,55,"Napa County, California",136484,44010,92474,89471,76967,2440,544,8986,313,221,3003,0.573,0500000US06055,Napa County,138019,48829,89190,83462,68909,2300,507,10520,316,910,5728,0.618,0.045,0.078,4.5%,7.8%
0500000US06057,06057,6,57,"Nevada County, California",98764,8439,90325,87953,85477,341,793,1124,96,122,2372,0.243,0500000US06057,Nevada County,102241,10416,91825,86028,82810,416,695,1371,119,617,5797,0.330,0.087,0.359,8.7%,35.9%
0500000US06059,06059,6,59,"Orange County, California",3010232,1012973,1997259,1925142,1328499,44000,6216,532477,8357,5593,72117,0.660,0500000US06059,Orange County,3186989,1086834,2100155,1974913,1198655,49304,5298,699124,7714,14818,125242,0.692,0.032,0.049,3.2%,4.9%
0500000US06061,06061,6,61,"Placer County, California",348432,44710,303722,293064,265294,4427,2080,19963,697,603,10658,0.399,0500000US06061,Placer County,404739,60628,344111,318755,272471,6440,2010,34776,967,2091,25356,0.513,0.113,0.284,11.3%,28.4%
0500000US06063,06063,6,63,"Plumas County, California",20007,1605,18402,17819,17015,181,460,127,18,18,583,0.269,0500000US06063,Plumas County,19790,1897,17893,16782,15999,102,382,145,40,114,1111,0.334,0.065,0.241,6.5%,24.1%
0500000US06065,06065,6,65,"Riverside County, California",2189641,995257,1194384,1146274,869068,130823,10931,125921,5849,3682,48110,0.628,0500000US06065,Riverside County,2418185,1202295,1215890,1130978,788235,146762,11960,164889,6767,12365,84912,0.637,0.008,0.013,0.8%,1.3%
0500000US06067,06067,6,67,"Sacramento County, California",1418788,306196,1112592,1050451,687166,139949,7875,198944,13099,3418,62141,0.687,0500000US06067,Sacramento County,1585055,374434,1210621,1107837,650271,145724,7432,276295,18011,10104,102784,0.733,0.045,0.066,4.5%,6.6%
0500000US06069,06069,6,69,"San Benito County, California",55269,31186,24083,23170,21154,355,231,1298,65,67,913,0.534,0500000US06069,San Benito County,64209,39241,24968,23133,19785,479,221,2189,127,332,1835,0.529,-0.005,-0.009,-0.5%,-0.9%
0500000US06071,06071,6,71,"San Bernardino County, California",2035210,1001145,1034065,990699,677598,170700,8523,123978,5845,4055,43366,0.636,0500000US06071,San Bernardino County,2181654,1170913,1010741,942341,566113,173322,8412,176204,6173,12117,68400,0.631,-0.005,-0.008,-0.5%,-0.8%
0500000US06073,06073,6,73,"San Diego County, California",3095313,991348,2103965,2009022,1500047,146600,14098,328058,13504,6715,94943,0.648,0500000US06073,San Diego County,3298634,1119629,2179005,2011765,1422205,145014,12841,400589,12991,18125,167240,0.680,0.031,0.049,3.1%,4.9%
0500000US06075,06075,6,75,"San Francisco County, California",805235,121774,683461,657382,337451,46781,1828,265700,3128,2494,26079,0.688,0500000US06075,San Francisco County,873965,136761,737204,691758,341306,45071,1570,294220,3244,6347,45446,0.704,0.016,0.023,1.6%,2.3%
0500000US06077,06077,6,77,"San Joaquin County, California",685306,266341,418965,396816,245919,48540,3179,94547,3248,1383,22149,0.695,0500000US06077,San Joaquin County,779233,325725,453508,419416,215530,56898,3135,134684,4977,4192,34092,0.712,0.017,0.024,1.7%,2.4%
0500000US06079,06079,6,79,"San Luis Obispo County, California",269637,55973,213664,207427,191696,5128,1367,8106,346,784,6237,0.450,0500000US06079,San Luis Obispo County,282424,67921,214503,200889,183468,4330,1136,10001,340,1614,13614,0.516,0.067,0.148,6.7%,14.8%
0500000US06081,06081,6,81,"San Mateo County, California",718451,182502,535949,512024,303609,18763,1125,175934,9884,2709,23925,0.695,0500000US06081,San Mateo County,764442,191386,573056,534087,275902,14701,1021,227783,8840,5840,38969,0.715,0.020,0.029,2.0%,2.9%
0500000US06083,06083,6,83,"Santa Barbara County, California",423895,181687,242208,233268,203122,7242,1843,19591,680,790,8940,0.584,0500000US06083,Santa Barbara County,448229,210584,237645,221242,184746,6467,1731,25378,542,2378,16403,0.605,0.021,0.036,2.1%,3.6%
0500000US06085,06085,6,85,"Santa Clara County, California",1781642,479210,1302432,1248877,626909,42331,4042,565466,6252,3877,53555,0.702,0500000US06085,Santa Clara County,1936259,487357,1448902,1370635,555708,42148,3240,753399,5945,10195,78267,0.701,-0.001,-0.001,-0.1%,-0.1%
0500000US06087,06087,6,87,"Santa Cruz County, California",262382,84092,178290,171241,156397,2304,978,10658,292,612,7049,0.540,0500000US06087,Santa Cruz County,270861,94299,176562,163252,145551,2850,853,12072,277,1649,13310,0.585,0.046,0.085,4.6%,8.5%
0500000US06089,06089,6,89,"Shasta County, California",177223,14878,162345,156385,146044,1438,4162,4297,232,212,5960,0.312,0500000US06089,Shasta County,182155,19730,162425,149901,136894,1761,4047,5839,323,1037,12524,0.417,0.106,0.339,10.6%,33.9%
0500000US06091,06091,6,91,"Sierra County, California",3240,269,2971,2916,2855,5,41,12,2,1,55,0.216,0500000US06091,Sierra County,3236,377,2859,2673,2615,7,18,7,1,25,186,0.330,0.114,0.527,11.4%,52.7%
0500000US06093,06093,6,93,"Siskiyou County, California",44900,4615,40285,38445,35683,552,1549,528,69,64,1840,0.355,0500000US06093,Siskiyou County,44076,5527,38549,35454,32057,471,1757,866,38,265,3095,0.448,0.094,0.264,9.4%,26.4%
0500000US06095,06095,6,95,"Solano County, California",413344,99356,313988,292968,168628,58743,1864,59027,3243,1463,21020,0.733,0500000US06095,Solano County,453491,128155,325336,294516,155125,60051,1624,70953,3775,2988,30820,0.756,0.024,0.033,2.4%,3.3%
0500000US06097,06097,6,97,"Sonoma County, California",483878,120430,363448,350504,320027,6769,3584,17777,1434,913,12944,0.498,0500000US06097,Sonoma County,488863,141438,347425,322826,285792,7125,3053,22239,1708,2909,24599,0.570,0.071,0.143,7.1%,14.3%
0500000US06099,06099,6,99,"Stanislaus County, California",514453,215658,298795,284928,240423,13065,2870,24712,3016,842,13867,0.602,0500000US06099,Stanislaus County,552878,265978,286900,264447,207908,14302,2621,33169,3713,2734,22453,0.621,0.019,0.032,1.9%,3.2%
0500000US06101,06101,6,101,"Sutter County, California",94737,27251,67486,64308,47782,1713,925,13442,256,190,3178,0.641,0500000US06101,Sutter County,99633,31568,68065,62906,41366,1774,862,18014,279,611,5159,0.691,0.050,0.078,5.0%,7.8%
0500000US06103,06103,6,103,"Tehama County, California",63463,13906,49557,47913,45603,349,1205,625,64,67,1644,0.434,0500000US06103,Tehama County,65829,17938,47891,44303,41340,391,1167,985,96,324,3588,0.528,0.093,0.215,9.3%,21.5%
0500000US06105,06105,6,105,"Trinity County, California",13786,959,12827,12250,11518,45,558,93,16,20,577,0.294,0500000US06105,Trinity County,16112,937,15175,14198,11374,66,416,2212,24,106,977,0.475,0.181,0.618,18.1%,61.8%
0500000US06107,06107,6,107,"Tulare County, California",442179,268065,174114,167970,143935,5497,3323,14204,370,641,6144,0.525,0500000US06107,Tulare County,473117,309895,163222,152452,125022,5332,3458,15997,511,2132,10770,0.499,-0.026,-0.049,-2.6%,-4.9%
0500000US06109,06109,6,109,"Tuolumne County, California",55365,5918,49447,48091,45325,1114,830,530,62,230,1356,0.317,0500000US06109,Tuolumne County,55620,7124,48496,45220,42254,989,784,770,110,313,3276,0.402,0.085,0.269,8.5%,26.9%
0500000US06111,06111,6,111,"Ventura County, California",823318,331567,491751,473162,400868,13082,2389,54099,1353,1371,18589,0.596,0500000US06111,Ventura County,843843,365285,478558,445692,360850,13704,2020,63252,1415,4451,32866,0.622,0.027,0.045,2.7%,4.5%
0500000US06113,06113,6,113,"Yolo County, California",200849,60953,139896,132990,100240,4752,1098,25640,817,443,6906,0.641,0500000US06113,Yolo County,216403,71700,144703,132810,93911,5722,948,29872,1079,1278,11893,0.679,0.038,0.060,3.8%,6.0%
0500000US06115,06115,6,115,"Yuba County, California",72155,18051,54104,50880,42416,2122,1260,4710,270,102,3224,0.584,0500000US06115,Yuba County,81575,23520,58055,52029,41750,2831,1034,5583,372,459,6026,0.643,0.059,0.101,5.9%,10.1%
0500000US08001,08001,8,1,"Adams County, Colorado",441603,167878,273725,266239,234970,12207,2478,15431,476,677,7486,0.570,0500000US08001,Adams County,519572,216649,302923,283923,239295,16054,2869,22583,753,2369,19000,0.610,0.040,0.070,4.0%,7.0%
0500000US08003,08003,8,3,"Alamosa County, Colorado",15445,7110,8335,8108,7667,138,134,130,6,33,227,0.541,0500000US08003,Alamosa County,16376,7701,8675,8181,7490,211,215,142,19,104,494,0.568,0.027,0.050,2.7%,5.0%
0500000US08005,08005,8,5,"Arapahoe County, Colorado",572003,105522,466481,450423,361747,55657,2386,28595,1036,1002,16058,0.553,0500000US08005,Arapahoe County,655070,135729,519341,485891,368047,68152,2654,41855,1634,3549,33450,0.624,0.071,0.128,7.1%,12.8%
0500000US08007,08007,8,7,"Archuleta County, Colorado",12084,2148,9936,9749,9446,33,166,79,4,21,187,0.357,0500000US08007,Archuleta County,13359,2159,11200,10570,10175,41,170,101,6,77,630,0.391,0.034,0.096,3.4%,9.6%
0500000US08009,08009,8,9,"Baca County, Colorado",3788,348,3440,3394,3323,20,39,6,0,6,46,0.222,0500000US08009,Baca County,3506,346,3160,3018,2916,19,38,8,0,37,142,0.297,0.075,0.338,7.5%,33.8%
0500000US08011,08011,8,11,"Bent County, Colorado",6499,1985,4514,4478,3832,491,91,56,4,4,36,0.553,0500000US08011,Bent County,5650,1760,3890,3707,3315,255,90,39,0,8,183,0.555,0.002,0.004,0.2%,0.4%
0500000US08013,08013,8,13,"Boulder County, Colorado",294567,39276,255291,249694,233741,2265,1061,11996,153,478,5597,0.350,0500000US08013,Boulder County,330758,48168,282590,267816,245203,3149,1112,16291,241,1820,14774,0.425,0.074,0.212,7.4%,21.2%
0500000US08014,08014,8,14,"Broomfield County, Colorado",55889,6216,49673,48609,44358,530,244,3368,43,66,1064,0.354,0500000US08014,Broomfield County,74112,9919,64193,60555,53904,927,197,5096,80,351,3638,0.446,0.092,0.261,9.2%,26.1%
0500000US08015,08015,8,15,"Chaffee County, Colorado",17809,1678,16131,15951,15417,267,143,104,8,12,180,0.241,0500000US08015,Chaffee County,19476,1841,17635,16866,16195,295,132,133,11,100,769,0.298,0.056,0.234,5.6%,23.4%
0500000US08017,08017,8,17,"Cheyenne County, Colorado",1836,178,1658,1646,1617,7,11,10,1,0,12,0.215,0500000US08017,Cheyenne County,1748,206,1542,1482,1470,1,5,3,0,3,60,0.278,0.063,0.293,6.3%,29.3%
0500000US08019,08019,8,19,"Clear Creek County, Colorado",9088,429,8659,8542,8371,50,56,51,3,11,117,0.149,0500000US08019,Clear Creek County,9397,648,8749,8366,8149,49,41,82,7,38,383,0.241,0.092,0.620,9.2%,62.0%
0500000US08021,08021,8,21,"Conejos County, Colorado",8256,4620,3636,3556,3451,12,47,18,4,24,80,0.512,0500000US08021,Conejos County,7461,3779,3682,3570,3465,14,44,21,2,24,112,0.527,0.016,0.030,1.6%,3.0%
0500000US08023,08023,8,23,"Costilla County, Colorado",3524,2327,1197,1167,1086,6,29,34,0,12,30,0.469,0500000US08023,Costilla County,3499,1988,1511,1369,1234,33,34,55,0,13,142,0.551,0.082,0.175,8.2%,17.5%
0500000US08025,08025,8,25,"Crowley County, Colorado",5823,1686,4137,4078,3369,555,91,59,0,4,59,0.572,0500000US08025,Crowley County,5922,1608,4314,4175,3438,510,151,69,2,5,139,0.580,0.009,0.015,0.9%,1.5%
0500000US08027,08027,8,27,"Custer County, Colorado",4255,200,4055,3999,3914,41,23,16,0,5,56,0.151,0500000US08027,Custer County,4704,178,4526,4331,4212,10,42,22,0,45,195,0.195,0.044,0.288,4.4%,28.8%
0500000US08029,08029,8,29,"Delta County, Colorado",30952,4345,26607,26211,25685,137,190,146,12,41,396,0.291,0500000US08029,Delta County,31196,4329,26867,25586,24907,121,121,236,9,192,1281,0.341,0.050,0.172,5.0%,17.2%
0500000US08031,08031,8,31,"Denver County, Colorado",600158,190965,409193,396553,313012,58388,3525,19925,495,1208,12640,0.616,0500000US08031,Denver County,715522,199460,516062,485941,388764,61098,3740,27198,1395,3746,30121,0.617,0.001,0.001,0.1%,0.1%
0500000US08033,08033,8,33,"Dolores County, Colorado",2064,82,1982,1939,1877,3,55,2,2,0,43,0.170,0500000US08033,Dolores County,2326,176,2150,2019,1950,18,36,6,4,5,131,0.288,0.118,0.691,11.8%,69.1%
0500000US08035,08035,8,35,"Douglas County, Colorado",285465,21392,264073,258470,243297,3245,803,10563,175,387,5603,0.266,0500000US08035,Douglas County,357978,34110,323868,306176,278770,4788,970,19807,290,1551,17692,0.379,0.113,0.423,11.3%,42.3%
0500000US08037,08037,8,37,"Eagle County, Colorado",52197,15689,36508,36100,35105,243,134,517,15,86,408,0.457,0500000US08037,Eagle County,55731,16858,38873,37542,36202,296,118,712,27,187,1331,0.486,0.029,0.063,2.9%,6.3%
0500000US08039,08039,8,39,"Elbert County, Colorado",23086,1234,21852,21494,21005,159,126,165,22,17,358,0.169,0500000US08039,Elbert County,26062,2067,23995,22752,22185,123,116,184,21,123,1243,0.267,0.098,0.579,9.8%,57.9%
0500000US08041,08041,8,41,"El Paso County, Colorado",622263,93665,528598,506982,447947,35792,3693,16492,1911,1147,21616,0.454,0500000US08041,El Paso County,730395,129984,600411,554037,480484,40759,3816,21629,2750,4599,46374,0.527,0.074,0.162,7.4%,16.2%
0500000US08043,08043,8,43,"Fremont County, Colorado",46824,5770,41054,40447,37647,1805,686,274,16,19,607,0.336,0500000US08043,Fremont County,48939,6049,42890,40809,37713,1809,691,332,30,234,2081,0.387,0.051,0.151,5.1%,15.1%
0500000US08045,08045,8,45,"Garfield County, Colorado",56389,15978,40411,39783,38784,236,297,342,31,93,628,0.446,0500000US08045,Garfield County,61685,19564,42121,39953,38636,277,300,397,34,309,2168,0.506,0.059,0.133,5.9%,13.3%
0500000US08047,08047,8,47,"Gilpin County, Colorado",5441,267,5174,5096,4947,28,34,75,9,3,78,0.170,0500000US08047,Gilpin County,5808,380,5428,5146,4952,32,36,85,4,37,282,0.266,0.096,0.561,9.6%,56.1%
0500000US08049,08049,8,49,"Grand County, Colorado",14843,1116,13727,13554,13313,51,52,121,7,10,173,0.190,0500000US08049,Grand County,15717,1533,14184,13723,13435,59,56,83,17,73,461,0.259,0.069,0.365,6.9%,36.5%
0500000US08051,08051,8,51,"Gunnison County, Colorado",15324,1255,14069,13875,13658,45,61,94,4,13,194,0.199,0500000US08051,Gunnison County,16918,1604,15314,14640,14254,77,70,121,7,111,674,0.279,0.081,0.406,8.1%,40.6%
0500000US08053,08053,8,53,"Hinsdale County, Colorado",843,24,819,805,786,3,7,3,0,6,14,0.129,0500000US08053,Hinsdale County,788,30,758,716,693,8,6,2,1,6,42,0.222,0.093,0.716,9.3%,71.6%
0500000US08055,08055,8,55,"Huerfano County, Colorado",6711,2368,4343,4264,4151,22,54,19,10,8,79,0.493,0500000US08055,Huerfano County,6820,2130,4690,4434,4231,53,77,24,0,49,256,0.516,0.023,0.047,2.3%,4.7%
0500000US08057,08057,8,57,"Jackson County, Colorado",1394,150,1244,1233,1219,0,13,1,0,0,11,0.224,0500000US08057,Jackson County,1379,138,1241,1182,1161,0,12,2,2,5,59,0.279,0.056,0.249,5.6%,24.9%
0500000US08059,08059,8,59,"Jefferson County, Colorado",534543,76445,458098,449586,427160,5001,2638,13682,390,715,8512,0.340,0500000US08059,Jefferson County,582910,91514,491396,465770,435245,6653,2898,17694,464,2816,25626,0.415,0.075,0.220,7.5%,22.0%
0500000US08061,08061,8,61,"Kiowa County, Colorado",1398,78,1320,1310,1304,3,3,0,0,0,10,0.127,0500000US08061,Kiowa County,1446,104,1342,1261,1247,3,0,9,1,1,81,0.248,0.121,0.956,12.1%,95.6%
0500000US08063,08063,8,63,"Kit Carson County, Colorado",8270,1574,6696,6628,6320,217,48,34,6,3,68,0.379,0500000US08063,Kit Carson County,7087,1409,5678,5418,5306,21,24,30,5,32,260,0.399,0.020,0.052,2.0%,5.2%
0500000US08065,08065,8,65,"Lake County, Colorado",7310,2858,4452,4370,4252,22,46,28,4,18,82,0.509,0500000US08065,Lake County,7436,2662,4774,4486,4293,31,46,63,8,45,288,0.537,0.028,0.056,2.8%,5.6%
0500000US08067,08067,8,67,"La Plata County, Colorado",51334,6056,45278,44329,41245,176,2554,266,30,58,949,0.338,0500000US08067,La Plata County,55638,7008,48630,46174,42392,182,2809,381,33,377,2456,0.399,0.061,0.182,6.1%,18.2%
0500000US08069,08069,8,69,"Larimer County, Colorado",299630,31628,268002,262797,253047,2259,1277,5675,192,347,5205,0.275,0500000US08069,Larimer County,359066,44662,314404,297973,282581,3448,1495,8365,265,1819,16431,0.362,0.088,0.318,8.8%,31.8%
0500000US08071,08071,8,71,"Las Animas County, Colorado",15507,6446,9061,8878,8399,195,170,98,4,12,183,0.533,0500000US08071,Las Animas County,14555,5632,8923,8500,7965,183,145,108,12,87,423,0.550,0.016,0.030,1.6%,3.0%
0500000US08073,08073,8,73,"Lincoln County, Colorado",5467,683,4784,4707,4345,280,38,39,2,3,77,0.350,0500000US08073,Lincoln County,5675,809,4866,4671,4252,275,61,40,22,21,195,0.415,0.065,0.185,6.5%,18.5%
0500000US08075,08075,8,75,"Logan County, Colorado",22709,3551,19158,18957,17754,881,177,117,13,15,201,0.363,0500000US08075,Logan County,21528,3511,18017,17439,16337,753,161,119,17,52,578,0.395,0.033,0.090,3.3%,9.0%
0500000US08077,08077,8,77,"Mesa County, Colorado",146723,19552,127171,124958,121944,776,896,1059,150,133,2213,0.291,0500000US08077,Mesa County,155703,23278,132425,125392,120749,1020,933,1613,188,889,7033,0.374,0.083,0.285,8.3%,28.5%
0500000US08079,08079,8,79,"Mineral County, Colorado",712,21,691,685,678,2,4,1,0,0,6,0.092,0500000US08079,Mineral County,865,47,818,782,775,0,4,3,0,0,36,0.193,0.100,1.087,10.0%,108.7%
0500000US08081,08081,8,81,"Moffat County, Colorado",13795,1985,11810,11636,11412,32,98,76,7,11,174,0.295,0500000US08081,Moffat County,13292,2124,11168,10602,10313,77,98,52,2,60,566,0.371,0.076,0.257,7.6%,25.7%
0500000US08083,08083,8,83,"Montezuma County, Colorado",25535,2818,22717,22288,19168,47,2923,118,12,20,429,0.411,0500000US08083,Montezuma County,25849,3109,22740,21532,18035,72,3166,128,24,107,1208,0.482,0.071,0.172,7.1%,17.2%
0500000US08085,08085,8,85,"Montrose County, Colorado",41276,8127,33149,32630,31989,118,204,236,24,59,519,0.360,0500000US08085,Montrose County,42679,9027,33652,32090,31126,159,262,334,26,183,1562,0.422,0.062,0.171,6.2%,17.1%
0500000US08087,08087,8,87,"Morgan County, Colorado",28159,9506,18653,18407,17370,755,102,135,10,35,246,0.505,0500000US08087,Morgan County,29111,10566,18545,17832,16546,935,110,153,11,77,713,0.544,0.039,0.077,3.9%,7.7%
0500000US08089,08089,8,89,"Otero County, Colorado",18831,7596,11235,11009,10639,93,111,135,7,24,226,0.518,0500000US08089,Otero County,18690,7702,10988,10488,10013,134,112,98,28,103,500,0.542,0.024,0.047,2.4%,4.7%
0500000US08091,08091,8,91,"Ouray County, Colorado",4436,196,4240,4196,4143,6,14,25,5,3,44,0.126,0500000US08091,Ouray County,4874,292,4582,4394,4308,16,16,28,2,24,188,0.214,0.088,0.700,8.8%,70.0%
0500000US08093,08093,8,93,"Park County, Colorado",16206,783,15423,15143,14842,69,117,99,2,14,280,0.159,0500000US08093,Park County,17390,1235,16155,15311,14902,89,118,99,9,94,844,0.258,0.100,0.629,10.0%,62.9%
0500000US08095,08095,8,95,"Phillips County, Colorado",4442,830,3612,3587,3526,14,13,26,4,4,25,0.335,0500000US08095,Phillips County,4530,1155,3375,3296,3246,10,12,22,1,5,79,0.421,0.086,0.258,8.6%,25.8%
0500000US08097,08097,8,97,"Pitkin County, Colorado",17148,1561,15587,15403,15067,82,25,204,10,15,184,0.219,0500000US08097,Pitkin County,17358,1892,15466,14932,14433,94,36,280,7,82,534,0.295,0.076,0.347,7.6%,34.7%
0500000US08099,08099,8,99,"Prowers County, Colorado",12551,4417,8134,8043,7873,54,65,38,2,11,91,0.483,0500000US08099,Prowers County,11999,4680,7319,6974,6686,83,118,31,6,50,345,0.536,0.054,0.112,5.4%,11.2%
0500000US08101,08101,8,101,"Pueblo County, Colorado",159063,65811,93252,91183,86054,2646,985,1123,111,264,2069,0.536,0500000US08101,Pueblo County,168162,69921,98241,92412,85527,2995,1246,1562,138,944,5829,0.567,0.031,0.058,3.1%,5.8%
0500000US08103,08103,8,103,"Rio Blanco County, Colorado",6666,665,6001,5887,5756,49,44,22,11,5,114,0.244,0500000US08103,Rio Blanco County,6529,622,5907,5642,5509,29,51,22,2,29,265,0.277,0.033,0.136,3.3%,13.6%
0500000US08105,08105,8,105,"Rio Grande County, Colorado",11982,5086,6896,6787,6600,25,104,40,2,16,109,0.516,0500000US08105,Rio Grande County,11539,4609,6930,6545,6261,51,137,36,4,56,385,0.545,0.029,0.055,2.9%,5.5%
0500000US08107,08107,8,107,"Routt County, Colorado",23509,1600,21909,21645,21310,91,68,145,16,15,264,0.174,0500000US08107,Routt County,24829,2200,22629,21758,21242,153,67,169,35,92,871,0.259,0.085,0.492,8.5%,49.2%
0500000US08109,08109,8,109,"Saguache County, Colorado",6108,2452,3656,3575,3446,11,68,47,1,2,81,0.520,0500000US08109,Saguache County,6368,2394,3974,3785,3578,19,81,63,2,42,189,0.542,0.022,0.042,2.2%,4.2%
0500000US08111,08111,8,111,"San Juan County, Colorado",699,84,615,605,595,0,1,7,0,2,10,0.261,0500000US08111,San Juan County,705,90,615,585,575,1,6,2,0,1,30,0.317,0.056,0.215,5.6%,21.5%
0500000US08113,08113,8,113,"San Miguel County, Colorado",7359,630,6729,6630,6514,19,33,52,4,8,99,0.209,0500000US08113,San Miguel County,8072,882,7190,6923,6757,20,47,55,0,44,267,0.286,0.077,0.370,7.7%,37.0%
0500000US08115,08115,8,115,"Sedgwick County, Colorado",2379,289,2090,2069,2036,7,8,17,0,1,21,0.253,0500000US08115,Sedgwick County,2404,363,2041,1967,1934,3,10,12,0,8,74,0.329,0.076,0.302,7.6%,30.2%
0500000US08117,08117,8,117,"Summit County, Colorado",27994,3989,24005,23734,23158,208,55,269,13,31,271,0.295,0500000US08117,Summit County,31055,5335,25720,24658,23782,232,67,407,20,150,1062,0.383,0.088,0.297,8.8%,29.7%
0500000US08119,08119,8,119,"Teller County, Colorado",23350,1294,22056,21609,21148,104,167,155,20,15,447,0.176,0500000US08119,Teller County,24710,1716,22994,21632,21017,132,122,201,12,148,1362,0.269,0.092,0.524,9.2%,52.4%
0500000US08121,08121,8,121,"Washington County, Colorado",4814,407,4407,4357,4306,30,7,11,1,2,50,0.193,0500000US08121,Washington County,4817,516,4301,4134,4057,24,8,15,10,20,167,0.278,0.085,0.443,8.5%,44.3%
0500000US08123,08123,8,123,"Weld County, Colorado",252825,71680,181145,177690,170827,2054,1419,2873,158,359,3455,0.463,0500000US08123,Weld County,328981,98462,230519,218652,205881,4154,1327,5682,303,1305,11867,0.517,0.054,0.117,5.4%,11.7%
0500000US08125,08125,8,125,"Yuma County, Colorado",10043,2088,7955,7905,7824,16,33,20,3,9,50,0.350,0500000US08125,Yuma County,9988,2771,7217,7040,6948,21,16,26,2,27,177,0.439,0.089,0.254,8.9%,25.4%
0500000US09001,09001,9,1,"Fairfield County, Connecticut",916829,155025,761804,748140,606716,92705,967,41801,256,5695,13664,0.521,0500000US09001,Fairfield County,957419,205351,752068,715131,552125,99992,858,50751,173,11232,36937,0.606,0.085,0.163,8.5%,16.3%
0500000US09003,09003,9,3,"Hartford County, Connecticut",894014,136783,757231,742615,591283,110005,1272,37581,186,2288,14616,0.522,0500000US09003,Hartford County,899498,166275,733223,701581,523105,118154,1166,53325,172,5659,31642,0.606,0.084,0.160,8.4%,16.0%
0500000US09005,09005,9,5,"Litchfield County, Connecticut",189927,8535,181392,179050,173403,2206,284,2877,41,239,2342,0.164,0500000US09005,Litchfield County,185186,14580,170606,163254,155601,2957,268,3434,63,931,7352,0.286,0.122,0.743,12.2%,74.3%
0500000US09007,09007,9,7,"Middlesex County, Connecticut",165676,7834,157842,155160,143144,7256,210,4207,53,290,2682,0.248,0500000US09007,Middlesex County,164245,11928,152317,145879,131954,8001,214,4923,43,744,6438,0.344,0.096,0.386,9.6%,38.6%
0500000US09009,09009,9,9,"New Haven County, Connecticut",862477,129743,732734,718461,582384,101763,1421,29933,196,2764,14273,0.506,0500000US09009,New Haven County,864835,170081,694754,664569,509688,110273,1413,36995,247,5953,30185,0.595,0.089,0.175,8.9%,17.5%
0500000US09011,09011,9,11,"New London County, Connecticut",274055,23214,250841,243163,214605,14488,2077,11248,159,586,7678,0.374,0500000US09011,New London County,268555,30920,237635,223556,194894,14422,1977,10633,215,1415,14079,0.453,0.079,0.210,7.9%,21.0%
0500000US09013,09013,9,13,"Tolland County, Connecticut",152691,6602,146089,143823,133589,4701,218,5084,29,202,2266,0.230,0500000US09013,Tolland County,149788,9699,140089,134395,120021,5074,182,8438,44,636,5694,0.348,0.118,0.510,11.8%,51.0%
0500000US09015,09015,9,15,"Windham County, Connecticut",118428,11351,107077,105093,101138,1995,436,1360,38,126,1984,0.261,0500000US09015,Windham County,116418,14459,101959,96717,91844,2064,326,1960,17,506,5242,0.360,0.099,0.379,9.9%,37.9%
0500000US10001,10001,10,1,"Kent County, Delaware",162310,9346,152964,148306,105891,37812,916,3266,74,347,4658,0.516,0500000US10001,Kent County,181851,13981,167870,156943,104845,45737,864,4362,107,1028,10927,0.594,0.079,0.153,7.9%,15.3%
0500000US10003,10003,10,3,"New Castle County, Delaware",538479,46921,491558,481353,331836,124426,984,23132,102,873,10205,0.557,0500000US10003,New Castle County,570719,63516,507203,484250,303265,142388,893,35022,127,2555,22953,0.638,0.081,0.145,8.1%,14.5%
0500000US10005,10005,10,5,"Sussex County, Delaware",197145,16954,180191,176770,149025,24544,924,1910,62,305,3421,0.405,0500000US10005,Sussex County,237378,26793,210585,201442,171741,24835,764,3014,70,1018,9143,0.451,0.046,0.113,4.6%,11.3%
0500000US11001,11001,11,1,"District of Columbia, District of Columbia",601723,54749,546974,534324,209464,301053,1322,20818,216,1451,12650,0.619,0500000US11001,District of Columbia,689545,77652,611893,582408,261771,282066,1277,33192,349,3753,29485,0.672,0.053,0.086,5.3%,8.6%
0500000US12001,12001,12,1,"Alachua County, Florida",247336,20752,226584,221412,157466,49420,603,13098,122,703,5172,0.544,0500000US12001,Alachua County,278468,33614,244854,231856,160463,51171,562,17891,101,1668,12998,0.613,0.069,0.126,6.9%,12.6%
0500000US12003,12003,12,3,"Baker County, Florida",27115,520,26595,26223,22353,3651,72,129,5,13,372,0.302,0500000US12003,Baker County,28259,973,27286,26374,22185,3825,109,157,14,84,912,0.363,0.061,0.204,6.1%,20.4%
0500000US12005,12005,12,5,"Bay County, Florida",168852,8107,160745,156328,133790,17844,1033,3298,140,223,4417,0.358,0500000US12005,Bay County,175216,13846,161370,151674,128348,17549,795,4068,194,720,9696,0.444,0.086,0.240,8.6%,24.0%
0500000US12007,12007,12,7,"Bradford County, Florida",28520,1020,27500,27114,21066,5777,85,149,11,26,386,0.412,0500000US12007,Bradford County,28303,1350,26953,26049,20320,5427,58,135,12,97,904,0.444,0.033,0.079,3.3%,7.9%
0500000US12009,12009,12,9,"Brevard County, Florida",543376,43943,499433,488410,421466,52677,1709,11098,385,1075,11023,0.382,0500000US12009,Brevard County,606612,67907,538705,508461,430936,56498,1569,15587,482,3389,30244,0.471,0.089,0.234,8.9%,23.4%
0500000US12011,12011,12,11,"Broward County, Florida",1748066,438247,1309819,1279494,760817,449677,3394,55692,762,9152,30325,0.680,0500000US12011,Broward County,1944375,608703,1335672,1260890,644230,517618,2917,74040,696,21389,74782,0.718,0.038,0.056,3.8%,5.6%
0500000US12013,12013,12,13,"Calhoun County, Florida",14625,755,13870,13577,11357,1991,144,71,8,6,293,0.375,0500000US12013,Calhoun County,13648,622,13026,12307,10490,1668,93,46,0,10,719,0.389,0.014,0.038,1.4%,3.8%
0500000US12015,12015,12,15,"Charlotte County, Florida",159978,9213,150765,148715,137628,8622,348,1884,49,184,2050,0.253,0500000US12015,Charlotte County,186847,14079,172768,166366,153700,8870,385,2566,63,782,6402,0.314,0.061,0.239,6.1%,23.9%
0500000US12017,12017,12,17,"Citrus County, Florida",141236,6584,134652,132875,126549,3767,418,1979,33,129,1777,0.194,0500000US12017,Citrus County,153843,9241,144602,138806,131477,3891,466,2412,43,517,5796,0.264,0.070,0.360,7.0%,36.0%
0500000US12019,12019,12,19,"Clay County, Florida",190865,14609,176256,171990,147257,18085,734,5429,179,306,4266,0.389,0500000US12019,Clay County,218245,23134,195111,183340,148986,25621,680,6626,363,1064,11771,0.505,0.117,0.300,11.7%,30.0%
0500000US12021,12021,12,21,"Collier County, Florida",321520,83177,238343,235556,211156,19898,609,3390,72,431,2787,0.498,0500000US12021,Collier County,375752,102249,273503,265542,235455,22554,551,5419,61,1502,7961,0.529,0.031,0.063,3.1%,6.3%
0500000US12023,12023,12,23,"Columbia County, Florida",67531,3276,64255,63195,50475,11663,316,611,36,94,1060,0.409,0500000US12023,Columbia County,69698,5063,64635,61962,49096,11441,236,867,27,295,2673,0.470,0.061,0.150,6.1%,15.0%
0500000US12027,12027,12,27,"DeSoto County, Florida",34862,10425,24437,24151,19549,4338,62,169,4,29,286,0.581,0500000US12027,DeSoto County,33976,10011,23965,23184,18624,4203,80,189,8,80,781,0.597,0.016,0.028,1.6%,2.8%
0500000US12029,12029,12,29,"Dixie County, Florida",16422,512,15910,15701,14220,1364,63,48,2,4,209,0.242,0500000US12029,Dixie County,16759,688,16071,15453,13750,1551,61,58,0,33,618,0.315,0.073,0.302,7.3%,30.2%
0500000US12031,12031,12,31,"Duval County, Florida",864263,65398,798865,779780,488826,250063,2816,35381,688,2006,19085,0.588,0500000US12031,Duval County,995567,112689,882878,837138,492039,286344,2306,48652,960,6837,45740,0.656,0.067,0.114,6.7%,11.4%
0500000US12033,12033,12,33,"Escambia County, Florida",297619,14061,283558,275615,196901,67443,2384,8015,400,472,7943,0.507,0500000US12033,Escambia County,321905,20793,301112,283155,200962,68148,1998,9866,410,1771,17957,0.557,0.050,0.098,5.0%,9.8%
0500000US12035,12035,12,35,"Flagler County, Florida",95696,8251,87445,85910,72860,10470,223,2020,47,290,1535,0.400,0500000US12035,Flagler County,115378,12299,103079,98332,84291,10537,291,2450,59,704,4747,0.444,0.044,0.110,4.4%,11.0%
0500000US12037,12037,12,37,"Franklin County, Florida",11549,529,11020,10845,9188,1574,52,26,2,3,175,0.346,0500000US12037,Franklin County,12451,675,11776,11315,9798,1403,41,30,2,41,461,0.364,0.018,0.051,1.8%,5.1%
0500000US12039,12039,12,39,"Gadsden County, Florida",46389,4419,41970,41576,15335,25881,93,221,7,39,394,0.570,0500000US12039,Gadsden County,43826,5093,38733,37761,14093,23326,71,147,4,120,972,0.599,0.029,0.051,2.9%,5.1%
0500000US12041,12041,12,41,"Gilchrist County, Florida",16939,845,16094,15901,14882,884,63,59,1,12,193,0.223,0500000US12041,Gilchrist County,17864,1348,16516,15780,14827,788,62,56,2,45,736,0.302,0.079,0.355,7.9%,35.5%
0500000US12043,12043,12,43,"Glades County, Florida",12884,2720,10164,10061,7947,1538,518,46,2,10,103,0.559,0500000US12043,Glades County,12126,3050,9076,8838,7132,1434,193,34,0,45,238,0.576,0.017,0.031,1.7%,3.1%
0500000US12045,12045,12,45,"Gulf County, Florida",15863,678,15185,14929,11881,2937,59,41,3,8,256,0.403,0500000US12045,Gulf County,14192,555,13637,13071,11222,1692,66,57,0,34,566,0.357,-0.045,-0.112,-4.5%,-11.2%
0500000US12047,12047,12,47,"Hamilton County, Florida",14799,1306,13493,13318,8124,5038,70,73,0,13,175,0.575,0500000US12047,Hamilton County,14004,1455,12549,12167,7633,4422,43,43,0,26,382,0.592,0.017,0.029,1.7%,2.9%
0500000US12049,12049,12,49,"Hardee County, Florida",27731,11895,15836,15591,13315,1877,91,294,8,6,245,0.581,0500000US12049,Hardee County,25327,10604,14723,14242,11873,2111,55,165,3,35,481,0.598,0.017,0.029,1.7%,2.9%
0500000US12051,12051,12,51,"Hendry County, Florida",39140,19243,19897,19622,13650,5057,580,275,11,49,275,0.620,0500000US12051,Hendry County,39619,22112,17507,16902,12089,4195,155,339,4,120,605,0.584,-0.036,-0.058,-3.6%,-5.8%
0500000US12053,12053,12,53,"Hernando County, Florida",172778,17796,154982,152616,141847,8165,483,1815,62,244,2366,0.313,0500000US12053,Hernando County,194515,29045,165470,157640,144060,9507,553,2566,86,868,7830,0.425,0.112,0.358,11.2%,35.8%
0500000US12055,12055,12,55,"Highlands County, Florida",98786,17157,81629,80468,69804,8750,375,1402,37,100,1161,0.462,0500000US12055,Highlands County,101235,20943,80292,77244,65511,9484,291,1602,49,307,3048,0.528,0.066,0.143,6.6%,14.3%
0500000US12057,12057,12,57,"Hillsborough County, Florida",1229226,306635,922591,899796,660565,191260,2948,41328,703,2992,22795,0.623,0500000US12057,Hillsborough County,1459762,427381,1032381,975584,667791,224479,2817,69928,914,9655,56797,0.678,0.054,0.087,5.4%,8.7%
0500000US12059,12059,12,59,"Holmes County, Florida",19927,444,19483,19121,17722,1140,143,83,27,6,362,0.205,0500000US12059,Holmes County,19653,688,18965,18218,16766,1211,120,81,13,27,747,0.266,0.061,0.297,6.1%,29.7%
0500000US12061,12061,12,61,"Indian River County, Florida",138028,15465,122563,121015,106780,12074,277,1646,49,189,1548,0.381,0500000US12061,Indian River County,159788,20832,138956,133897,117422,13079,273,2341,52,730,5059,0.435,0.054,0.142,5.4%,14.2%
0500000US12063,12063,12,63,"Jackson County, Florida",49746,2143,47603,46824,33111,13106,305,227,25,50,779,0.485,0500000US12063,Jackson County,47319,2215,45104,43321,30629,12042,196,292,18,144,1783,0.513,0.027,0.056,2.7%,5.6%
0500000US12065,12065,12,65,"Jefferson County, Florida",14761,546,14215,14056,8668,5293,33,49,4,9,159,0.525,0500000US12065,Jefferson County,14510,658,13852,13447,8720,4600,36,34,3,54,405,0.535,0.010,0.020,1.0%,2.0%
0500000US12067,12067,12,67,"Lafayette County, Florida",8870,1076,7794,7704,6266,1396,20,13,2,7,90,0.461,0500000US12067,Lafayette County,8226,938,7288,7143,6074,1024,16,10,1,18,145,0.426,-0.035,-0.077,-3.5%,-7.7%
0500000US12069,12069,12,69,"Lake County, Florida",297052,36009,261043,256427,221365,27796,965,5055,194,1052,4616,0.421,0500000US12069,Lake County,383956,65375,318581,303708,253214,37883,1016,8362,317,2916,14873,0.524,0.104,0.246,10.4%,24.6%
0500000US12071,12071,12,71,"Lee County, Florida",618754,113308,505446,498121,439048,47751,1292,8252,197,1581,7325,0.457,0500000US12071,Lee County,760822,173161,587661,564669,490476,55958,1228,12789,244,3974,22992,0.526,0.069,0.152,6.9%,15.2%
0500000US12073,12073,12,73,"Leon County, Florida",275487,15361,260126,255132,163483,82386,681,7950,121,511,4994,0.554,0500000US12073,Leon County,292198,22914,269284,257473,157458,87503,631,10465,155,1261,11811,0.611,0.057,0.102,5.7%,10.2%
0500000US12075,12075,12,75,"Levy County, Florida",40801,3047,37754,37133,32958,3756,129,228,14,48,621,0.333,0500000US12075,Levy County,42915,4080,38835,37066,32874,3597,122,292,11,170,1769,0.395,0.062,0.187,6.2%,18.7%
0500000US12077,12077,12,77,"Liberty County, Florida",8365,518,7847,7732,6159,1472,77,16,0,8,115,0.423,0500000US12077,Liberty County,7974,562,7412,7179,5729,1353,52,18,1,26,233,0.449,0.026,0.062,2.6%,6.2%
0500000US12079,12079,12,79,"Madison County, Florida",19224,899,18325,18130,10582,7423,76,43,0,6,195,0.546,0500000US12079,Madison County,17968,881,17087,16574,10132,6281,53,45,0,63,513,0.557,0.011,0.020,1.1%,2.0%
0500000US12081,12081,12,81,"Manatee County, Florida",322833,47955,274878,270678,236950,27228,608,5203,168,521,4200,0.432,0500000US12081,Manatee County,399710,70979,328731,315289,273101,31147,779,8433,246,1583,13442,0.494,0.062,0.144,6.2%,14.4%
0500000US12083,12083,12,83,"Marion County, Florida",331298,36137,295161,290561,245136,39337,983,4337,121,647,4600,0.426,0500000US12083,Marion County,375908,55910,319998,305486,253837,42795,986,5973,148,1747,14512,0.507,0.081,0.190,8.1%,19.0%
0500000US12085,12085,12,85,"Martin County, Florida",146318,17881,128437,126974,117532,7493,248,1510,52,139,1463,0.337,0500000US12085,Martin County,158431,24187,134244,129524,119216,7277,218,2246,42,525,4720,0.407,0.070,0.208,7.0%,20.8%
0500000US12086,12086,12,86,"Miami-Dade County, Florida",2496435,1623859,872576,852477,383551,425650,2014,35841,468,4953,20099,0.524,0500000US12086,Miami-Dade County,2701767,1856938,844829,798586,361517,378756,1589,41672,385,14667,46243,0.489,-0.034,-0.066,-3.4%,-6.6%
0500000US12087,12087,12,87,"Monroe County, Florida",73090,15071,58019,57105,52089,3851,247,782,60,76,914,0.447,0500000US12087,Monroe County,82874,19432,63442,61022,54731,4517,169,1137,61,407,2420,0.505,0.058,0.131,5.8%,13.1%
0500000US12089,12089,12,89,"Nassau County, Florida",73314,2380,70934,70002,64410,4581,248,619,46,98,932,0.223,0500000US12089,Nassau County,90352,4449,85903,82192,75817,4945,222,863,52,293,3711,0.289,0.066,0.295,6.6%,29.5%
0500000US12091,12091,12,91,"Okaloosa County, Florida",180822,12296,168526,162644,139500,16333,895,5189,330,397,5882,0.390,0500000US12091,Okaloosa County,211668,22578,189090,174198,146271,18896,799,6578,448,1206,14892,0.497,0.107,0.274,10.7%,27.4%
0500000US12093,12093,12,93,"Okeechobee County, Florida",39996,9561,30435,30060,26258,3117,287,345,25,28,375,0.506,0500000US12093,Okeechobee County,39644,9857,29787,28744,24671,3318,263,332,14,146,1043,0.543,0.038,0.074,3.8%,7.4%
0500000US12095,12095,12,95,"Orange County, Florida",1145956,308244,837712,815260,526754,223200,2449,55541,1038,6278,22452,0.676,0500000US12095,Orange County,1429908,473025,956883,891192,531362,263624,2207,76870,1114,16015,65691,0.713,0.038,0.056,3.8%,5.6%
0500000US12097,12097,12,97,"Osceola County, Florida",268685,122146,146539,142133,108292,24503,596,7120,229,1393,4406,0.622,0500000US12097,Osceola County,388656,211089,177567,164897,113362,35145,562,11370,240,4218,12670,0.610,-0.012,-0.019,-1.2%,-1.9%
0500000US12099,12099,12,99,"Palm Beach County, Florida",1320134,250823,1069311,1052090,793571,221209,2171,30549,511,4079,17221,0.574,0500000US12099,Palm Beach County,1492191,349933,1142258,1091635,779759,255724,1536,43356,494,10766,50623,0.641,0.067,0.116,6.7%,11.6%
0500000US12101,12101,12,101,"Pasco County, Florida",464697,54536,410161,403003,372239,19010,1236,9609,223,686,7158,0.342,0500000US12101,Pasco County,561891,93157,468734,444851,392375,31601,1388,16408,308,2771,23883,0.479,0.137,0.400,13.7%,40.0%
0500000US12103,12103,12,103,"Pinellas County, Florida",916542,73241,843301,828049,704786,91922,2066,26749,724,1802,15252,0.391,0500000US12103,Pinellas County,959107,102439,856668,817168,684463,91431,1942,33700,797,4835,39500,0.467,0.076,0.195,7.6%,19.5%
0500000US12105,12105,12,105,"Polk County, Florida",602095,106532,495563,486651,388769,85336,1658,9567,238,1083,8912,0.531,0500000US12105,Polk County,725046,187695,537351,512359,392621,100950,1623,13181,300,3684,24992,0.619,0.088,0.165,8.8%,16.5%
0500000US12107,12107,12,107,"Putnam County, Florida",74364,6706,67658,66654,53981,11842,271,444,36,80,1004,0.439,0500000US12107,Putnam County,73321,7816,65505,62849,50541,11274,280,469,37,248,2656,0.488,0.049,0.112,4.9%,11.2%
0500000US12109,12109,12,109,"St. Johns County, Florida",190039,9972,180067,177323,162194,10388,457,3854,140,290,2744,0.265,0500000US12109,St. Johns County,273425,22607,250818,239052,214428,12940,544,9764,151,1225,11766,0.373,0.108,0.406,10.8%,40.6%
0500000US12111,12111,12,111,"St. Lucie County, Florida",277789,45995,231794,227267,170032,51373,664,4226,127,845,4527,0.563,0500000US12111,St. Lucie County,329226,66320,262906,249987,176533,64597,568,5678,141,2470,12919,0.632,0.068,0.121,6.8%,12.1%
0500000US12113,12113,12,113,"Santa Rosa County, Florida",151372,6507,144865,140968,128726,7940,1194,2690,200,218,3897,0.271,0500000US12113,Santa Rosa County,188000,11890,176110,164347,147518,10690,1112,3818,362,847,11763,0.373,0.101,0.374,10.1%,37.4%
0500000US12115,12115,12,115,"Sarasota County, Florida",379448,30033,349415,345146,321978,17036,667,4818,102,545,4269,0.271,0500000US12115,Sarasota County,434006,43236,390770,377037,349700,16165,695,8407,168,1902,13733,0.338,0.067,0.246,6.7%,24.6%
0500000US12117,12117,12,117,"Seminole County, Florida",422718,72457,350261,342490,280452,44196,995,15451,194,1202,7771,0.518,0500000US12117,Seminole County,470856,106539,364317,343495,264072,50276,765,25164,243,2975,20822,0.618,0.100,0.193,10.0%,19.3%
0500000US12119,12119,12,119,"Sumter County, Florida",93420,5582,87838,87082,77338,8736,294,609,28,77,756,0.302,0500000US12119,Sumter County,129752,7583,122169,119426,109213,8313,311,1238,31,320,2743,0.283,-0.019,-0.062,-1.9%,-6.2%
0500000US12121,12121,12,121,"Suwannee County, Florida",41551,3596,37955,37429,32300,4696,162,223,11,37,526,0.375,0500000US12121,Suwannee County,43474,4785,38689,37180,31664,4920,167,270,16,143,1509,0.443,0.068,0.181,6.8%,18.1%
0500000US12123,12123,12,123,"Taylor County, Florida",22570,777,21793,21452,16483,4629,171,149,5,15,341,0.423,0500000US12123,Taylor County,21796,866,20930,20196,15629,4196,102,224,0,45,734,0.446,0.023,0.054,2.3%,5.4%
0500000US12125,12125,12,125,"Union County, Florida",15535,743,14792,14604,11123,3391,52,32,2,4,188,0.437,0500000US12125,Union County,16147,764,15383,14921,11585,3197,42,35,0,62,462,0.443,0.006,0.013,0.6%,1.3%
0500000US12127,12127,12,127,"Volusia County, Florida",494593,55217,439376,432198,372982,49548,1356,7368,166,778,7178,0.408,0500000US12127,Volusia County,553543,82652,470891,449563,379527,55338,1262,10478,266,2692,21328,0.496,0.087,0.214,8.7%,21.4%
0500000US12129,12129,12,129,"Wakulla County, Florida",30776,1016,29760,29264,24472,4406,174,166,17,29,496,0.346,0500000US12129,Wakulla County,33764,1577,32187,30686,25987,4202,154,198,19,126,1501,0.388,0.042,0.122,4.2%,12.2%
0500000US12131,12131,12,131,"Walton County, Florida",55043,2921,52122,51057,46857,3147,463,491,37,62,1065,0.269,0500000US12131,Walton County,75305,6187,69118,65605,60644,3294,415,907,38,307,3513,0.340,0.072,0.267,7.2%,26.7%
0500000US12133,12133,12,133,"Washington County, Florida",24896,733,24163,23705,19551,3698,296,131,15,14,458,0.360,0500000US12133,Washington County,25318,924,24394,23189,19484,3236,222,132,28,87,1205,0.388,0.028,0.077,2.8%,7.7%
0500000US13001,13001,13,1,"Appling County, Georgia",18236,1704,16532,16400,12854,3360,40,125,11,10,132,0.460,0500000US13001,Appling County,18444,1825,16619,16202,12674,3339,33,123,1,32,417,0.485,0.024,0.053,2.4%,5.3%
0500000US13003,13003,13,3,"Atkinson County, Georgia",8375,2039,6336,6270,4776,1428,31,17,14,4,66,0.586,0500000US13003,Atkinson County,8286,2048,6238,6071,4801,1208,30,12,4,16,167,0.582,-0.005,-0.008,-0.5%,-0.8%
0500000US13005,13005,13,5,"Bacon County, Georgia",11096,791,10305,10185,8431,1696,8,34,10,6,120,0.394,0500000US13005,Bacon County,11140,875,10265,9930,8103,1747,4,40,4,32,335,0.439,0.045,0.115,4.5%,11.5%
0500000US13007,13007,13,7,"Baker County, Georgia",3451,145,3306,3278,1642,1600,9,24,2,1,28,0.557,0500000US13007,Baker County,2876,143,2733,2663,1514,1128,1,18,0,2,70,0.566,0.009,0.016,0.9%,1.6%
0500000US13009,13009,13,9,"Baldwin County, Georgia",45720,919,44801,44308,24704,18866,85,580,18,55,493,0.537,0500000US13009,Baldwin County,43799,1139,42660,41633,22432,18318,64,599,27,193,1027,0.561,0.024,0.045,2.4%,4.5%
0500000US13011,13011,13,11,"Banks County, Georgia",18395,1041,17354,17152,16526,416,36,165,0,9,202,0.189,0500000US13011,Banks County,18035,1164,16871,16251,15578,394,54,189,8,28,620,0.248,0.059,0.312,5.9%,31.2%
0500000US13013,13013,13,13,"Barrow County, Georgia",69367,6037,63330,62163,51736,7769,130,2359,28,141,1167,0.422,0500000US13013,Barrow County,83505,10560,72945,69562,55582,10141,130,3233,17,459,3383,0.523,0.101,0.239,10.1%,23.9%
0500000US13015,13015,13,15,"Bartow County, Georgia",100157,7690,92467,90976,79803,10024,288,705,54,102,1491,0.349,0500000US13015,Bartow County,108901,10751,98150,93397,80159,11309,254,1169,40,466,4753,0.436,0.087,0.248,8.7%,24.8%
0500000US13017,13017,13,17,"Ben Hill County, Georgia",17634,1026,16608,16435,10164,6087,47,120,2,15,173,0.545,0500000US13017,Ben Hill County,17194,1054,16140,15662,9219,6222,57,116,0,48,478,0.577,0.032,0.058,3.2%,5.8%
0500000US13019,13019,13,19,"Berrien County, Georgia",19286,885,18401,18227,16050,2040,44,82,3,8,174,0.294,0500000US13019,Berrien County,18160,1045,17115,16504,14396,1934,22,80,10,62,611,0.356,0.062,0.210,6.2%,21.0%
0500000US13021,13021,13,21,"Bibb County, Georgia",155547,4389,151158,149306,65494,80744,287,2492,74,215,1852,0.552,0500000US13021,Bibb County,157346,6737,150609,146155,56787,85234,281,3209,42,602,4454,0.573,0.021,0.038,2.1%,3.8%
0500000US13023,13023,13,23,"Bleckley County, Georgia",13063,301,12762,12660,9000,3533,7,109,3,8,102,0.452,0500000US13023,Bleckley County,12583,469,12114,11857,8867,2788,11,153,8,30,257,0.452,0.001,0.002,0.1%,0.2%
0500000US13025,13025,13,25,"Brantley County, Georgia",18411,343,18068,17834,17198,531,56,37,2,10,234,0.126,0500000US13025,Brantley County,18021,326,17695,17003,16317,562,45,42,3,34,692,0.177,0.051,0.407,5.1%,40.7%
0500000US13027,13027,13,27,"Brooks County, Georgia",16243,853,15390,15241,9425,5695,48,51,5,17,149,0.538,0500000US13027,Brooks County,16301,955,15346,14889,9066,5684,24,67,6,42,457,0.565,0.027,0.051,2.7%,5.1%
0500000US13029,13029,13,29,"Bryan County, Georgia",30233,1336,28897,28294,23446,4210,81,473,22,62,603,0.377,0500000US13029,Bryan County,44738,3269,41469,39022,31321,6330,102,1032,53,184,2447,0.481,0.104,0.277,10.4%,27.7%
0500000US13031,13031,13,31,"Bulloch County, Georgia",70217,2439,67778,66822,46251,19252,142,1013,58,106,956,0.489,0500000US13031,Bulloch County,81099,4180,76919,74240,49712,22775,159,1283,62,249,2679,0.541,0.052,0.106,5.2%,10.6%
0500000US13033,13033,13,33,"Burke County, Georgia",23316,617,22699,22459,10844,11469,47,68,20,11,240,0.541,0500000US13033,Burke County,24596,777,23819,23116,11941,10957,45,97,10,66,703,0.564,0.023,0.043,2.3%,4.3%
0500000US13035,13035,13,35,"Butts County, Georgia",23655,597,23058,22805,16200,6431,52,100,3,19,253,0.456,0500000US13035,Butts County,25434,803,24631,23750,16628,6808,39,102,9,164,881,0.499,0.042,0.093,4.2%,9.3%
0500000US13037,13037,13,37,"Calhoun County, Georgia",6694,262,6432,6383,2250,4092,9,30,0,2,49,0.512,0500000US13037,Calhoun County,5573,149,5424,5363,1766,3569,8,19,0,1,61,0.489,-0.023,-0.045,-2.3%,-4.5%
0500000US13039,13039,13,39,"Camden County, Georgia",50513,2590,47923,46676,35977,9621,230,706,70,72,1247,0.453,0500000US13039,Camden County,54768,3658,51110,48121,37203,9497,185,845,66,325,2989,0.501,0.048,0.105,4.8%,10.5%
0500000US13043,13043,13,43,"Candler County, Georgia",10998,1227,9771,9695,6949,2669,8,57,1,11,76,0.529,0500000US13043,Candler County,10981,1378,9603,9359,6567,2681,19,63,3,26,244,0.566,0.037,0.070,3.7%,7.0%
0500000US13045,13045,13,45,"Carroll County, Georgia",110527,6800,103727,101793,80531,19862,296,836,19,249,1934,0.433,0500000US13045,Carroll County,119148,9586,109562,104407,80725,21781,271,1104,21,505,5155,0.499,0.066,0.154,6.6%,15.4%
0500000US13047,13047,13,47,"Catoosa County, Georgia",63942,1469,62473,61537,59149,1356,191,762,30,49,936,0.143,0500000US13047,Catoosa County,67872,2341,65531,62511,59280,1808,181,1025,84,133,3020,0.233,0.090,0.630,9.0%,63.0%
0500000US13049,13049,13,49,"Charlton County, Georgia",12171,310,11861,11681,8116,3443,38,76,3,5,180,0.474,0500000US13049,Charlton County,12518,2036,10482,10099,7532,2386,40,109,2,30,383,0.574,0.100,0.210,10.0%,21.0%
0500000US13051,13051,13,51,"Chatham County, Georgia",265128,14370,250758,246282,133492,105274,587,6229,224,476,4476,0.585,0500000US13051,Chatham County,295291,23790,271501,260538,139433,108011,619,10620,408,1447,10963,0.634,0.049,0.084,4.9%,8.4%
0500000US13053,13053,13,53,"Chattahoochee County, Georgia",11267,1398,9869,9509,7089,2047,67,231,62,13,360,0.554,0500000US13053,Chattahoochee County,9565,1610,7955,7364,5403,1463,35,304,104,55,591,0.624,0.070,0.126,7.0%,12.6%
0500000US13055,13055,13,55,"Chattooga County, Georgia",26015,1043,24972,24657,21589,2886,48,108,2,24,315,0.297,0500000US13055,Chattooga County,24965,1297,23668,22698,20079,2391,45,102,0,81,970,0.340,0.042,0.143,4.2%,14.3%
0500000US13057,13057,13,57,"Cherokee County, Georgia",214346,20566,193780,190467,174243,11633,536,3484,84,487,3313,0.327,0500000US13057,Cherokee County,266620,32111,234509,222768,197867,17326,502,5429,100,1544,11741,0.428,0.102,0.311,10.2%,31.1%
0500000US13059,13059,13,59,"Clarke County, Georgia",116714,12192,104522,102639,66674,30695,141,4811,48,270,1883,0.592,0500000US13059,Clarke County,128671,14336,114335,109831,72201,31367,297,4920,66,980,4504,0.611,0.019,0.032,1.9%,3.2%
0500000US13061,13061,13,61,"Clay County, Georgia",3183,26,3157,3130,1188,1920,11,10,1,0,27,0.497,0500000US13061,Clay County,2848,41,2807,2750,1143,1593,1,6,0,7,57,0.525,0.029,0.058,2.9%,5.8%
0500000US13063,13063,13,63,"Clayton County, Georgia",259424,35447,223977,219601,36610,169020,562,12839,103,467,4376,0.534,0500000US13063,Clayton County,297595,42546,255049,247214,25902,205301,601,13491,119,1800,7835,0.493,-0.041,-0.077,-4.1%,-7.7%
0500000US13065,13065,13,65,"Clinch County, Georgia",6798,236,6562,6483,4536,1876,38,13,4,16,79,0.477,0500000US13065,Clinch County,6749,253,6496,6296,4256,1950,30,22,7,31,200,0.517,0.039,0.082,3.9%,8.2%
0500000US13067,13067,13,67,"Cobb County, Georgia",688078,84330,603748,590483,387438,168053,1332,30432,267,2961,13265,0.606,0500000US13067,Cobb County,766149,111240,654909,620751,369182,200072,1289,42533,293,7382,34158,0.673,0.067,0.111,6.7%,11.1%
0500000US13069,13069,13,69,"Coffee County, Georgia",42356,4352,38004,37578,25907,11227,87,302,9,46,426,0.545,0500000US13069,Coffee County,43092,5430,37662,36474,24158,11872,62,299,14,69,1188,0.593,0.048,0.088,4.8%,8.8%
0500000US13071,13071,13,71,"Colquitt County, Georgia",45498,7763,37735,37345,26759,10143,100,289,12,42,390,0.575,0500000US13071,Colquitt County,45898,8709,37189,36175,25588,9995,83,388,15,106,1014,0.605,0.030,0.052,3.0%,5.2%
0500000US13073,13073,13,73,"Columbia County, Georgia",124053,6175,117878,115075,91517,18084,350,4726,185,213,2803,0.430,0500000US13073,Columbia County,156010,11858,144152,135356,99111,27621,354,7102,271,897,8796,0.554,0.124,0.288,12.4%,28.8%
0500000US13075,13075,13,75,"Cook County, Georgia",17212,1024,16188,16024,11171,4684,38,113,2,16,164,0.501,0500000US13075,Cook County,17229,1134,16095,15595,10658,4753,29,100,4,51,500,0.536,0.035,0.070,3.5%,7.0%
0500000US13077,13077,13,77,"Coweta County, Georgia",127317,8493,118824,116763,92604,21744,284,1895,54,182,2061,0.437,0500000US13077,Coweta County,146158,11053,135105,129323,99421,25544,298,3329,62,669,5782,0.499,0.062,0.142,6.2%,14.2%
0500000US13079,13079,13,79,"Crawford County, Georgia",12630,301,12329,12181,9282,2806,52,32,2,7,148,0.410,0500000US13079,Crawford County,12130,415,11715,11256,8866,2267,45,31,3,44,459,0.428,0.018,0.045,1.8%,4.5%
0500000US13081,13081,13,81,"Crisp County, Georgia",23439,748,22691,22477,12216,10033,24,183,6,15,214,0.544,0500000US13081,Crisp County,20128,634,19494,18979,9892,8821,18,180,4,64,515,0.565,0.021,0.038,2.1%,3.8%
0500000US13083,13083,13,83,"Dade County, Georgia",16633,292,16341,16146,15796,142,65,114,5,24,195,0.098,0500000US13083,Dade County,16251,364,15887,15160,14786,141,68,129,5,31,727,0.170,0.072,0.738,7.2%,73.8%
0500000US13085,13085,13,85,"Dawson County, Georgia",22330,920,21410,21162,20847,97,73,124,8,13,248,0.127,0500000US13085,Dawson County,26798,1605,25193,24150,23544,200,63,235,14,94,1043,0.223,0.096,0.761,9.6%,76.1%
0500000US13087,13087,13,87,"Decatur County, Georgia",27842,1404,26438,26212,14615,11366,57,138,3,33,226,0.555,0500000US13087,Decatur County,29367,1911,27456,26807,14280,12200,64,183,16,64,649,0.586,0.031,0.056,3.1%,5.6%
0500000US13089,13089,13,89,"DeKalb County, Georgia",691893,67824,624069,612659,203395,370963,1239,35173,245,1644,11410,0.614,0500000US13089,DeKalb County,764382,81471,682911,656491,215895,384438,1161,50076,202,4719,26420,0.650,0.037,0.060,3.7%,6.0%
0500000US13091,13091,13,91,"Dodge County, Georgia",21796,732,21064,20878,14273,6451,39,101,3,11,186,0.482,0500000US13091,Dodge County,19925,620,19305,18878,12865,5847,21,95,8,42,427,0.496,0.013,0.027,1.3%,2.7%
0500000US13093,13093,13,93,"Dooly County, Georgia",14918,862,14056,13960,6461,7381,16,93,3,6,96,0.564,0500000US13093,Dooly County,11208,797,10411,10235,4611,5540,17,51,2,14,176,0.581,0.017,0.030,1.7%,3.0%
0500000US13095,13095,13,95,"Dougherty County, Georgia",94565,2073,92492,91545,27315,63198,177,719,52,84,947,0.469,0500000US13095,Dougherty County,85790,2413,83377,81380,20631,59720,128,647,20,234,1997,0.456,-0.013,-0.028,-1.3%,-2.8%
0500000US13097,13097,13,97,"Douglas County, Georgia",132403,11125,121278,118950,64911,51387,321,1876,128,327,2328,0.601,0500000US13097,Douglas County,144237,16035,128202,122457,49877,68763,335,2313,97,1072,5745,0.639,0.037,0.062,3.7%,6.2%
0500000US13099,13099,13,99,"Early County, Georgia",11008,171,10837,10769,5250,5441,34,37,2,5,68,0.528,0500000US13099,Early County,10854,186,10668,10436,4813,5534,31,47,0,11,232,0.543,0.015,0.028,1.5%,2.8%
0500000US13101,13101,13,101,"Echols County, Georgia",4034,1183,2851,2795,2555,163,55,12,1,9,56,0.511,0500000US13101,Echols County,3697,1091,2606,2522,2328,147,37,8,0,2,84,0.514,0.003,0.007,0.3%,0.7%
0500000US13103,13103,13,103,"Effingham County, Georgia",52250,1501,50749,49935,42311,6982,135,425,16,66,814,0.325,0500000US13103,Effingham County,64769,3492,61277,58106,48204,8747,181,677,28,269,3171,0.422,0.097,0.299,9.7%,29.9%
0500000US13105,13105,13,105,"Elbert County, Georgia",20166,967,19199,19040,12956,5906,37,121,5,15,159,0.499,0500000US13105,Elbert County,19637,996,18641,18127,12610,5253,26,182,3,53,514,0.513,0.014,0.027,1.4%,2.7%
0500000US13107,13107,13,107,"Emanuel County, Georgia",22598,921,21677,21510,13733,7541,46,154,3,33,167,0.518,0500000US13107,Emanuel County,22768,993,21775,21277,13815,7246,33,141,2,40,498,0.528,0.011,0.020,1.1%,2.0%
0500000US13109,13109,13,109,"Evans County, Georgia",11000,1441,9559,9467,6228,3165,9,60,0,5,92,0.579,0500000US13109,Evans County,10774,1237,9537,9246,6038,3083,15,78,11,21,291,0.590,0.011,0.018,1.1%,1.8%
0500000US13111,13111,13,111,"Fannin County, Georgia",23682,431,23251,22999,22761,75,68,72,6,17,252,0.076,0500000US13111,Fannin County,25319,753,24566,23692,23351,85,85,113,3,55,874,0.147,0.071,0.943,7.1%,94.3%
0500000US13113,13113,13,113,"Fayette County, Georgia",106567,6760,99807,97928,72202,21117,221,4106,61,221,1879,0.496,0500000US13113,Fayette County,119194,9480,109714,104776,68144,29166,212,6362,44,848,4938,0.602,0.106,0.215,10.6%,21.5%
0500000US13115,13115,13,115,"Floyd County, Georgia",96317,8987,87330,86036,70959,13494,194,1225,56,108,1294,0.429,0500000US13115,Floyd County,98584,11466,87118,83560,67747,13940,191,1287,24,371,3558,0.493,0.064,0.150,6.4%,15.0%
0500000US13117,13117,13,117,"Forsyth County, Georgia",175511,16550,158961,156837,140943,4287,362,10875,54,316,2124,0.342,0500000US13117,Forsyth County,251283,25226,226057,216775,159407,10455,456,45117,85,1255,9282,0.552,0.210,0.616,21.0%,61.6%
0500000US13119,13119,13,119,"Franklin County, Georgia",22084,866,21218,20913,18913,1821,29,121,4,25,305,0.258,0500000US13119,Franklin County,23424,1121,22303,21527,19262,1888,34,261,3,79,776,0.314,0.056,0.216,5.6%,21.6%
0500000US13121,13121,13,121,"Fulton County, Georgia",920581,72566,848015,832230,376014,400457,1586,51304,287,2582,15785,0.634,0500000US13121,Fulton County,1066710,86302,980408,942611,404793,448803,1558,80632,381,6444,37797,0.665,0.031,0.049,3.1%,4.9%
0500000US13123,13123,13,123,"Gilmer County, Georgia",28292,2677,25615,25346,25078,98,72,65,15,18,269,0.205,0500000US13123,Gilmer County,31353,3599,27754,26767,26365,127,62,131,0,82,987,0.279,0.073,0.358,7.3%,35.8%
0500000US13125,13125,13,125,"Glascock County, Georgia",3082,33,3049,3014,2750,251,7,1,0,5,35,0.197,0500000US13125,Glascock County,2884,52,2832,2778,2573,196,0,7,2,0,54,0.199,0.002,0.009,0.2%,0.9%
0500000US13127,13127,13,127,"Glynn County, Georgia",79626,5126,74500,73348,51602,20525,146,894,74,107,1152,0.509,0500000US13127,Glynn County,84499,6336,78163,75250,52987,20469,175,1175,92,352,2913,0.541,0.032,0.063,3.2%,6.3%
0500000US13129,13129,13,129,"Gordon County, Georgia",55186,7738,47448,46797,44107,1945,130,522,49,44,651,0.340,0500000US13129,Gordon County,57544,8957,48587,46371,43317,2075,122,719,15,123,2216,0.406,0.066,0.194,6.6%,19.4%
0500000US13131,13131,13,131,"Grady County, Georgia",25011,2500,22511,22278,14879,7129,135,94,10,31,233,0.555,0500000US13131,Grady County,26236,3273,22963,22291,14715,7285,89,110,6,86,672,0.592,0.037,0.067,3.7%,6.7%
0500000US13133,13133,13,133,"Greene County, Georgia",15994,893,15101,14966,8771,6078,38,54,10,15,135,0.552,0500000US13133,Greene County,18915,1289,17626,17171,11126,5783,28,174,2,58,455,0.555,0.004,0.006,0.4%,0.6%
0500000US13135,13135,13,135,"Gwinnett County, Georgia",805321,162035,643286,627568,354316,184122,1535,84763,343,2489,15718,0.702,0500000US13135,Gwinnett County,957062,220460,736602,702641,310583,257124,1532,126526,387,6489,33961,0.751,0.048,0.069,4.8%,6.9%
0500000US13137,13137,13,137,"Habersham County, Georgia",43041,5333,37708,37150,34621,1412,81,955,47,34,558,0.336,0500000US13137,Habersham County,46031,6880,39151,37633,34694,1722,83,990,35,109,1518,0.407,0.071,0.211,7.1%,21.1%
0500000US13139,13139,13,139,"Hall County, Georgia",179684,46906,132778,130916,114300,12757,372,3181,57,249,1862,0.522,0500000US13139,Hall County,203136,57010,146126,140006,120418,14256,341,4198,85,708,6120,0.564,0.042,0.080,4.2%,8.0%
0500000US13141,13141,13,141,"Hancock County, Georgia",9429,139,9290,9240,2212,6959,21,47,1,0,50,0.400,0500000US13141,Hancock County,8735,63,8672,8509,2413,6025,23,37,1,10,163,0.448,0.048,0.119,4.8%,11.9%
0500000US13143,13143,13,143,"Haralson County, Georgia",28780,318,28462,28083,26516,1342,63,139,2,21,379,0.149,0500000US13143,Haralson County,29919,497,29422,28416,26825,1253,56,186,9,87,1006,0.193,0.044,0.298,4.4%,29.8%
0500000US13145,13145,13,145,"Harris County, Georgia",32024,872,31152,30747,24848,5457,100,280,17,45,405,0.368,0500000US13145,Harris County,34668,1417,33251,31743,25925,5170,101,388,21,138,1508,0.415,0.047,0.127,4.7%,12.7%
0500000US13147,13147,13,147,"Hart County, Georgia",25213,786,24427,24164,19213,4691,28,211,0,21,263,0.384,0500000US13147,Hart County,25828,931,24897,24033,19250,4324,36,335,2,86,864,0.414,0.030,0.079,3.0%,7.9%
0500000US13149,13149,13,149,"Heard County, Georgia",11834,223,11611,11436,10190,1152,32,56,2,4,175,0.248,0500000US13149,Heard County,11412,253,11159,10638,9589,930,33,53,4,29,521,0.285,0.036,0.146,3.6%,14.6%
0500000US13151,13151,13,151,"Henry County, Georgia",203922,11813,192109,188137,107083,74056,482,5902,110,504,3972,0.588,0500000US13151,Henry County,240712,18437,222275,212900,86297,116431,427,7976,119,1650,9375,0.629,0.041,0.070,4.1%,7.0%
0500000US13153,13153,13,153,"Houston County, Georgia",139900,8515,131385,128296,84703,39535,392,3360,96,210,3089,0.549,0500000US13153,Houston County,163633,11807,151826,144274,86211,51992,339,4905,124,703,7552,0.613,0.064,0.117,6.4%,11.7%
0500000US13155,13155,13,155,"Irwin County, Georgia",9538,228,9310,9247,6719,2459,2,61,0,6,63,0.437,0500000US13155,Irwin County,9666,663,9003,8785,6402,2224,15,119,1,24,218,0.503,0.066,0.152,6.6%,15.2%
0500000US13157,13157,13,157,"Jackson County, Georgia",60485,3736,56749,55933,50695,4050,91,1026,12,59,816,0.289,0500000US13157,Jackson County,75907,6712,69195,66395,59064,5136,127,1744,30,294,2800,0.380,0.091,0.317,9.1%,31.7%
0500000US13159,13159,13,159,"Jasper County, Georgia",13900,510,13390,13214,10095,3030,40,30,1,18,176,0.424,0500000US13159,Jasper County,14588,684,13904,13332,10771,2442,34,22,1,62,572,0.423,0.000,-0.001,0.0%,-0.1%
0500000US13161,13161,13,161,"Jeff Davis County, Georgia",15068,1577,13491,13371,11056,2212,27,70,0,6,120,0.429,0500000US13161,Jeff Davis County,14779,2047,12732,12359,9950,2293,26,50,7,33,373,0.503,0.074,0.172,7.4%,17.2%
0500000US13163,13163,13,163,"Jefferson County, Georgia",16930,517,16413,16299,7015,9187,18,64,2,13,114,0.533,0500000US13163,Jefferson County,15709,462,15247,14920,6834,7970,21,70,0,25,327,0.552,0.019,0.036,1.9%,3.6%
0500000US13165,13165,13,165,"Jenkins County, Georgia",8340,334,8006,7927,4508,3353,22,36,1,7,79,0.544,0500000US13165,Jenkins County,8674,303,8371,8223,4611,3536,29,12,5,30,148,0.550,0.005,0.010,0.5%,1.0%
0500000US13167,13167,13,167,"Johnson County, Georgia",9980,186,9794,9729,6219,3461,17,22,3,7,65,0.491,0500000US13167,Johnson County,9189,117,9072,8897,5800,3017,23,28,15,14,175,0.493,0.002,0.005,0.2%,0.5%
0500000US13169,13169,13,169,"Jones County, Georgia",28669,315,28354,28081,20830,6977,61,186,2,25,273,0.413,0500000US13169,Jones County,28347,476,27871,27077,20074,6739,46,138,7,73,794,0.441,0.028,0.069,2.8%,6.9%
0500000US13171,13171,13,171,"Lamar County, Georgia",18317,341,17976,17690,11943,5621,34,68,2,22,286,0.480,0500000US13171,Lamar County,18500,475,18025,17399,12344,4888,13,102,4,48,626,0.483,0.003,0.006,0.3%,0.6%
0500000US13173,13173,13,173,"Lanier County, Georgia",10078,461,9617,9412,6899,2367,38,101,3,4,205,0.474,0500000US13173,Lanier County,9877,572,9305,8892,6595,2138,31,81,14,33,413,0.502,0.029,0.060,2.9%,6.0%
0500000US13175,13175,13,175,"Laurens County, Georgia",48434,1143,47291,46798,28920,17268,87,478,4,41,493,0.516,0500000US13175,Laurens County,49570,1424,48146,46842,27881,18219,80,507,14,141,1304,0.547,0.031,0.061,3.1%,6.1%
0500000US13177,13177,13,177,"Lee County, Georgia",28298,560,27738,27411,21453,5239,66,609,19,25,327,0.390,0500000US13177,Lee County,33163,953,32210,31103,22758,7331,57,850,9,98,1107,0.478,0.088,0.225,8.8%,22.5%
0500000US13179,13179,13,179,"Liberty County, Georgia",63453,6159,57294,55078,27085,26018,287,1182,364,142,2216,0.639,0500000US13179,Liberty County,65256,7786,57470,53622,24004,27309,225,1325,437,322,3848,0.671,0.033,0.051,3.3%,5.1%
0500000US13181,13181,13,181,"Lincoln County, Georgia",7996,98,7898,7832,5201,2562,27,32,1,9,66,0.474,0500000US13181,Lincoln County,7690,92,7598,7363,5196,2116,18,20,3,10,235,0.467,-0.007,-0.016,-0.7%,-1.6%
0500000US13183,13183,13,183,"Long County, Georgia",14464,1778,12686,12301,8491,3541,76,110,51,32,385,0.580,0500000US13183,Long County,16168,1979,14189,13207,8774,4028,62,164,88,91,982,0.625,0.045,0.078,4.5%,7.8%
0500000US13185,13185,13,185,"Lowndes County, Georgia",109233,5238,103995,102251,61234,38815,305,1561,92,244,1744,0.557,0500000US13185,Lowndes County,118251,7872,110379,106022,59306,43946,312,1908,100,450,4357,0.604,0.048,0.085,4.8%,8.5%
0500000US13187,13187,13,187,"Lumpkin County, Georgia",29966,1344,28622,28163,27519,310,167,133,24,10,459,0.154,0500000US13187,Lumpkin County,33488,1790,31698,30200,29241,412,151,257,21,118,1498,0.232,0.078,0.507,7.8%,50.7%
0500000US13189,13189,13,189,"McDuffie County, Georgia",21875,475,21400,21139,12310,8661,56,74,15,23,261,0.526,0500000US13189,McDuffie County,21632,790,20842,20232,11417,8644,45,76,13,37,610,0.560,0.034,0.064,3.4%,6.4%
0500000US13191,13191,13,191,"McIntosh County, Georgia",14333,227,14106,13958,8716,5132,46,45,5,14,148,0.502,0500000US13191,McIntosh County,10975,231,10744,10346,7060,3176,32,43,0,35,398,0.501,-0.001,-0.002,-0.1%,-0.2%
0500000US13193,13193,13,193,"Macon County, Georgia",14740,527,14213,14095,4961,8902,19,190,18,5,118,0.520,0500000US13193,Macon County,12082,472,11610,11426,4078,7150,15,156,7,20,184,0.534,0.013,0.026,1.3%,2.6%
0500000US13195,13195,13,195,"Madison County, Georgia",28120,1139,26981,26694,24106,2320,63,173,0,32,287,0.257,0500000US13195,Madison County,30120,1956,28164,26977,23549,2753,44,521,4,106,1187,0.374,0.118,0.459,11.8%,45.9%
0500000US13197,13197,13,197,"Marion County, Georgia",8742,570,8172,8073,5100,2837,40,77,13,6,99,0.550,0500000US13197,Marion County,7498,560,6938,6701,4486,2122,12,55,15,11,237,0.555,0.005,0.010,0.5%,1.0%
0500000US13199,13199,13,199,"Meriwether County, Georgia",21992,347,21645,21417,12606,8583,67,141,2,18,228,0.519,0500000US13199,Meriwether County,20613,475,20138,19555,12084,7273,64,78,6,50,583,0.530,0.012,0.023,1.2%,2.3%
0500000US13201,13201,13,201,"Miller County, Georgia",6125,93,6032,5971,4237,1697,14,23,0,0,61,0.444,0500000US13201,Miller County,6000,136,5864,5738,3949,1748,9,26,1,5,126,0.481,0.037,0.082,3.7%,8.2%
0500000US13205,13205,13,205,"Mitchell County, Georgia",23498,1028,22470,22281,10894,11185,60,120,4,18,189,0.556,0500000US13205,Mitchell County,21755,964,20791,20346,10106,10054,37,108,0,41,445,0.568,0.012,0.021,1.2%,2.1%
0500000US13207,13207,13,207,"Monroe County, Georgia",26424,535,25889,25641,19101,6249,64,209,4,14,248,0.421,0500000US13207,Monroe County,27957,714,27243,26397,19954,6084,34,239,0,86,846,0.442,0.021,0.049,2.1%,4.9%
0500000US13209,13209,13,209,"Montgomery County, Georgia",9123,480,8643,8553,6144,2372,6,26,1,4,90,0.476,0500000US13209,Montgomery County,8610,571,8039,7843,5665,2120,11,34,0,13,196,0.502,0.026,0.054,2.6%,5.4%
0500000US13211,13211,13,211,"Morgan County, Georgia",17868,494,17374,17181,12814,4199,45,106,0,17,193,0.430,0500000US13211,Morgan County,20097,712,19385,18825,14487,4105,42,122,1,68,560,0.437,0.007,0.016,0.7%,1.6%
0500000US13213,13213,13,213,"Murray County, Georgia",39628,5154,34474,34098,33666,212,94,110,1,15,376,0.261,0500000US13213,Murray County,39973,5914,34059,32693,32164,263,79,127,2,58,1366,0.329,0.068,0.261,6.8%,26.1%
0500000US13215,13215,13,215,"Muscogee County, Georgia",189885,12110,177775,173479,82890,85119,599,4061,378,432,4296,0.603,0500000US13215,Muscogee County,206922,16513,190409,181411,79083,94701,488,5546,517,1076,8998,0.635,0.032,0.053,3.2%,5.3%
0500000US13217,13217,13,217,"Newton County, Georgia",99958,4635,95323,93649,51995,40371,199,881,34,169,1674,0.564,0500000US13217,Newton County,112483,7164,105319,101059,46746,52246,175,1044,114,734,4260,0.606,0.042,0.075,4.2%,7.5%
0500000US13219,13219,13,219,"Oconee County, Georgia",32808,1436,31372,31002,28306,1610,31,1016,4,35,370,0.250,0500000US13219,Oconee County,41799,2347,39452,38051,33886,1897,31,2066,0,171,1401,0.334,0.084,0.335,8.4%,33.5%
0500000US13221,13221,13,221,"Oglethorpe County, Georgia",14899,546,14353,14104,11429,2557,33,65,2,18,249,0.380,0500000US13221,Oglethorpe County,14825,869,13956,13383,10903,2248,40,134,5,53,573,0.431,0.051,0.133,5.1%,13.3%
0500000US13223,13223,13,223,"Paulding County, Georgia",142324,7264,135060,132477,106739,23810,353,1237,58,280,2583,0.407,0500000US13223,Paulding County,168661,12564,156097,148555,108444,36609,394,1926,114,1068,7542,0.532,0.125,0.308,12.5%,30.8%
0500000US13225,13225,13,225,"Peach County, Georgia",27695,1890,25805,25461,12499,12647,59,222,8,26,344,0.583,0500000US13225,Peach County,27981,2547,25434,24619,12119,12139,63,194,6,98,815,0.615,0.032,0.055,3.2%,5.5%
0500000US13227,13227,13,227,"Pickens County, Georgia",29431,819,28612,28304,27802,297,69,118,5,13,308,0.107,0500000US13227,Pickens County,33216,1198,32018,30758,30122,286,85,191,4,70,1260,0.175,0.068,0.639,6.8%,63.9%
0500000US13229,13229,13,229,"Pierce County, Georgia",18758,887,17871,17656,15860,1646,70,58,12,10,215,0.275,0500000US13229,Pierce County,19716,998,18718,18168,16403,1597,41,82,0,45,550,0.298,0.023,0.083,2.3%,8.3%
0500000US13231,13231,13,231,"Pike County, Georgia",17869,193,17676,17454,15506,1825,52,55,1,15,222,0.236,0500000US13231,Pike County,18889,348,18541,17925,16313,1445,28,77,0,62,616,0.247,0.011,0.045,1.1%,4.5%
0500000US13233,13233,13,233,"Polk County, Georgia",41475,4885,36590,36054,30492,5150,73,270,16,53,536,0.430,0500000US13233,Polk County,42853,5585,37268,35797,30161,5119,101,239,21,156,1471,0.472,0.042,0.098,4.2%,9.8%
0500000US13235,13235,13,235,"Pulaski County, Georgia",12010,465,11545,11455,7494,3808,30,103,2,18,90,0.508,0500000US13235,Pulaski County,9855,327,9528,9334,6022,3161,8,92,3,48,194,0.522,0.014,0.027,1.4%,2.7%
0500000US13237,13237,13,237,"Putnam County, Georgia",21218,1347,19871,19687,14024,5497,27,107,9,23,184,0.492,0500000US13237,Putnam County,22047,1557,20490,19883,14316,5385,33,108,1,40,607,0.513,0.021,0.043,2.1%,4.3%
0500000US13239,13239,13,239,"Quitman County, Georgia",2513,34,2479,2468,1265,1198,3,2,0,0,11,0.519,0500000US13239,Quitman County,2235,31,2204,2141,1190,917,13,12,0,9,63,0.547,0.028,0.054,2.8%,5.4%
0500000US13241,13241,13,241,"Rabun County, Georgia",16276,1301,14975,14796,14468,144,53,114,7,10,179,0.203,0500000US13241,Rabun County,16883,1452,15431,14856,14625,107,28,60,1,35,575,0.241,0.038,0.186,3.8%,18.6%
0500000US13243,13243,13,243,"Randolph County, Georgia",7719,119,7600,7559,2781,4747,5,22,0,4,41,0.492,0500000US13243,Randolph County,6425,143,6282,6168,2250,3862,9,21,3,23,114,0.515,0.023,0.048,2.3%,4.8%
0500000US13245,13245,13,245,"Richmond County, Georgia",200549,8207,192342,188133,76236,107365,570,3278,374,310,4209,0.566,0500000US13245,Richmond County,206607,11449,195158,187058,68397,112947,511,3907,391,905,8100,0.587,0.020,0.035,2.0%,3.5%
0500000US13247,13247,13,247,"Rockdale County, Georgia",85215,8063,77152,75781,34826,38996,179,1498,52,230,1371,0.614,0500000US13247,Rockdale County,93570,9540,84030,80674,24500,53785,168,1532,72,617,3356,0.589,-0.025,-0.041,-2.5%,-4.1%
0500000US13249,13249,13,249,"Schley County, Georgia",5010,161,4849,4817,3612,1167,2,36,0,0,32,0.425,0500000US13249,Schley County,4547,175,4372,4253,3357,863,4,20,2,7,119,0.417,-0.008,-0.019,-0.8%,-1.9%
0500000US13251,13251,13,251,"Screven County, Georgia",14593,180,14413,14274,7898,6283,33,56,1,3,139,0.521,0500000US13251,Screven County,14067,287,13780,13437,8018,5285,39,61,3,31,343,0.533,0.011,0.022,1.1%,2.2%
0500000US13253,13253,13,253,"Seminole County, Georgia",8729,204,8525,8458,5516,2887,12,33,0,10,67,0.491,0500000US13253,Seminole County,9147,228,8919,8670,5617,2961,6,61,0,25,249,0.517,0.026,0.053,2.6%,5.3%
0500000US13255,13255,13,255,"Spalding County, Georgia",64073,2451,61622,60752,38986,20937,153,567,30,79,870,0.521,0500000US13255,Spalding County,67306,3666,63640,61317,37105,23148,154,640,23,247,2323,0.574,0.052,0.100,5.2%,10.0%
0500000US13257,13257,13,257,"Stephens County, Georgia",26175,633,25542,25115,22006,2821,68,175,13,32,427,0.281,0500000US13257,Stephens County,26784,857,25927,24642,21323,2936,73,225,9,76,1285,0.351,0.070,0.250,7.0%,25.0%
0500000US13259,13259,13,259,"Stewart County, Georgia",6058,1454,4604,4553,1655,2833,11,44,1,9,51,0.649,0500000US13259,Stewart County,5314,1217,4097,3989,1338,2461,10,167,5,8,108,0.668,0.019,0.030,1.9%,3.0%
0500000US13261,13261,13,261,"Sumter County, Georgia",32819,1717,31102,30841,13413,16894,95,418,9,12,261,0.565,0500000US13261,Sumter County,29616,1770,27846,27181,11528,15051,40,503,4,55,665,0.586,0.021,0.037,2.1%,3.7%
0500000US13263,13263,13,263,"Talbot County, Georgia",6865,91,6774,6708,2639,4039,18,9,0,3,66,0.506,0500000US13263,Talbot County,5733,112,5621,5512,2427,3056,5,17,1,6,109,0.536,0.030,0.059,3.0%,5.9%
0500000US13265,13265,13,265,"Taliaferro County, Georgia",1717,35,1682,1659,625,1024,2,8,0,0,23,0.511,0500000US13265,Taliaferro County,1559,69,1490,1436,591,833,4,6,0,2,54,0.568,0.056,0.110,5.6%,11.0%
0500000US13267,13267,13,267,"Tattnall County, Georgia",25520,2502,23018,22800,15196,7424,54,99,11,16,218,0.551,0500000US13267,Tattnall County,22842,2303,20539,20001,13825,5961,36,127,6,46,538,0.555,0.004,0.007,0.4%,0.7%
0500000US13269,13269,13,269,"Taylor County, Georgia",8906,164,8742,8674,5123,3485,5,57,0,4,68,0.516,0500000US13269,Taylor County,7816,168,7648,7468,4584,2807,27,29,2,19,180,0.526,0.010,0.020,1.0%,2.0%
0500000US13271,13271,13,271,"Telfair County, Georgia",16500,2026,14474,14364,8429,5830,8,90,4,3,110,0.599,0500000US13271,Telfair County,12477,1928,10549,10371,5970,4326,28,30,0,17,178,0.627,0.028,0.046,2.8%,4.6%
0500000US13273,13273,13,273,"Terrell County, Georgia",9315,157,9158,9095,3366,5683,14,29,0,3,63,0.497,0500000US13273,Terrell County,9185,177,9008,8809,3189,5540,11,57,1,11,199,0.515,0.018,0.036,1.8%,3.6%
0500000US13275,13275,13,275,"Thomas County, Georgia",44720,1275,43445,43025,26081,16416,166,306,7,49,420,0.524,0500000US13275,Thomas County,45798,1577,44221,42942,25994,16259,150,406,9,124,1279,0.550,0.026,0.049,2.6%,4.9%
0500000US13277,13277,13,277,"Tift County, Georgia",40118,4037,36081,35724,23555,11549,72,507,8,33,357,0.562,0500000US13277,Tift County,41344,5219,36125,35037,22189,12049,56,650,2,91,1088,0.610,0.048,0.086,4.8%,8.6%
0500000US13279,13279,13,279,"Toombs County, Georgia",27223,3055,24168,23895,16887,6716,37,199,14,42,273,0.542,0500000US13279,Toombs County,27030,3044,23986,23310,16007,6980,31,207,6,79,676,0.569,0.028,0.051,2.8%,5.1%
0500000US13281,13281,13,281,"Towns County, Georgia",10471,206,10265,10215,10102,39,30,43,0,1,50,0.069,0500000US13281,Towns County,12493,415,12078,11740,11469,124,28,81,3,35,338,0.155,0.086,1.257,8.6%,125.7%
0500000US13283,13283,13,283,"Treutlen County, Georgia",6885,103,6782,6730,4466,2239,10,13,0,2,52,0.473,0500000US13283,Treutlen County,6406,170,6236,6097,4065,1999,19,7,0,7,139,0.499,0.026,0.054,2.6%,5.4%
0500000US13285,13285,13,285,"Troup County, Georgia",67044,2170,64874,64021,40408,22319,134,1054,21,85,853,0.524,0500000US13285,Troup County,69426,2956,66470,64266,38099,24157,127,1608,36,239,2204,0.574,0.050,0.095,5.0%,9.5%
0500000US13287,13287,13,287,"Turner County, Georgia",8930,282,8648,8598,4820,3697,19,40,0,22,50,0.536,0500000US13287,Turner County,9006,372,8634,8425,4700,3644,7,49,0,25,209,0.562,0.025,0.047,2.5%,4.7%
0500000US13289,13289,13,289,"Twiggs County, Georgia",9023,124,8899,8810,5059,3703,27,14,1,6,89,0.517,0500000US13289,Twiggs County,8022,124,7898,7657,4487,3099,16,37,0,18,241,0.537,0.020,0.038,2.0%,3.8%
0500000US13291,13291,13,291,"Union County, Georgia",21356,519,20837,20598,20345,95,66,75,4,13,239,0.092,0500000US13291,Union County,24632,816,23816,23009,22646,126,74,100,0,63,807,0.153,0.061,0.664,6.1%,66.4%
0500000US13293,13293,13,293,"Upson County, Georgia",27153,588,26565,26273,18522,7544,61,124,3,19,292,0.457,0500000US13293,Upson County,27700,633,27067,26181,18009,7851,63,151,1,106,886,0.495,0.038,0.084,3.8%,8.4%
0500000US13295,13295,13,295,"Walker County, Georgia",68756,1113,67643,66696,63343,2809,170,291,30,53,947,0.149,0500000US13295,Walker County,67654,1685,65969,63165,59654,2840,149,293,25,204,2804,0.218,0.069,0.465,6.9%,46.5%
0500000US13297,13297,13,297,"Walton County, Georgia",83768,2683,81085,80008,65677,12993,194,947,38,159,1077,0.360,0500000US13297,Walton County,96673,5228,91445,87828,68499,17136,188,1409,44,552,3617,0.462,0.102,0.284,10.2%,28.4%
0500000US13299,13299,13,299,"Ware County, Georgia",36312,1207,35105,34662,23583,10662,97,278,7,35,443,0.491,0500000US13299,Ware County,36251,1612,34639,33518,22275,10703,77,333,18,112,1121,0.532,0.042,0.085,4.2%,8.5%
0500000US13301,13301,13,301,"Warren County, Georgia",5834,54,5780,5749,2133,3584,9,21,0,2,31,0.489,0500000US13301,Warren County,5215,53,5162,5065,1974,3047,18,15,1,10,97,0.515,0.026,0.053,2.6%,5.3%
0500000US13303,13303,13,303,"Washington County, Georgia",21187,407,20780,20613,9339,11124,19,104,1,26,167,0.530,0500000US13303,Washington County,19988,334,19654,19253,8412,10698,37,76,0,30,401,0.536,0.006,0.012,0.6%,1.2%
0500000US13305,13305,13,305,"Wayne County, Georgia",30099,1719,28380,27937,21749,5928,82,160,6,12,443,0.436,0500000US13305,Wayne County,30144,1732,28412,27542,21301,5877,58,174,2,130,870,0.458,0.023,0.053,2.3%,5.3%
0500000US13307,13307,13,307,"Webster County, Georgia",2799,98,2701,2677,1492,1177,0,7,0,1,24,0.538,0500000US13307,Webster County,2348,59,2289,2220,1136,1063,0,12,6,3,69,0.559,0.022,0.040,2.2%,4.0%
0500000US13309,13309,13,309,"Wheeler County, Georgia",7421,356,7065,7011,4405,2582,6,16,0,2,54,0.524,0500000US13309,Wheeler County,7471,272,7199,7064,4157,2875,9,17,0,6,135,0.541,0.016,0.031,1.6%,3.1%
0500000US13311,13311,13,311,"White County, Georgia",27144,647,26497,26172,25453,454,120,124,9,12,325,0.120,0500000US13311,White County,28003,913,27090,25806,24959,467,105,159,0,116,1284,0.202,0.082,0.688,8.2%,68.8%
0500000US13313,13313,13,313,"Whitfield County, Georgia",102599,32471,70128,69046,63818,3631,180,1292,29,96,1082,0.511,0500000US13313,Whitfield County,102864,36916,65948,63327,57875,3553,182,1394,19,304,2621,0.553,0.041,0.081,4.1%,8.1%
0500000US13315,13315,13,315,"Wilcox County, Georgia",9255,338,8917,8846,5544,3233,15,41,1,12,71,0.518,0500000US13315,Wilcox County,8766,272,8494,8345,5185,3096,3,49,3,9,149,0.524,0.006,0.012,0.6%,1.2%
0500000US13317,13317,13,317,"Wilkes County, Georgia",10593,361,10232,10088,5495,4516,14,48,1,14,144,0.548,0500000US13317,Wilkes County,9565,399,9166,8889,4952,3838,22,59,0,18,277,0.568,0.021,0.038,2.1%,3.8%
0500000US13319,13319,13,319,"Wilkinson County, Georgia",9563,214,9349,9259,5529,3664,20,31,1,14,90,0.518,0500000US13319,Wilkinson County,8877,239,8638,8341,5110,3163,30,22,3,13,297,0.540,0.021,0.041,2.1%,4.1%
0500000US13321,13321,13,321,"Worth County, Georgia",21679,335,21344,21133,15044,5951,48,74,4,12,211,0.443,0500000US13321,Worth County,20784,381,20403,19879,14427,5255,49,87,8,53,524,0.453,0.011,0.024,1.1%,2.4%
0500000US15001,15001,15,1,"Hawaii County, Hawaii",185079,21383,163696,120155,57831,899,586,39588,20970,281,43541,0.775,0500000US15001,Hawaii County,200629,22275,178354,132032,64688,1159,649,38351,26185,1000,46322,0.777,0.002,0.002,0.2%,0.2%
0500000US15003,15003,15,3,"Honolulu County, Hawaii",953207,77433,875774,698853,181684,17929,1699,410019,86235,1287,176921,0.729,0500000US15003,Honolulu County,1016508,92322,924186,725649,175530,19356,1116,429410,97063,3174,198537,0.736,0.007,0.009,0.7%,0.9%
0500000US15005,15005,15,5,"Kalawao County, Hawaii",90,1,89,75,24,0,0,7,44,0,14,0.660,0500000US15005,Kalawao County,82,18,64,55,27,0,0,9,15,4,9,0.783,0.124,0.188,12.4%,18.8%
0500000US15007,15007,15,7,"Kauai County, Hawaii",67091,6315,60776,47113,20611,258,158,20296,5716,74,13663,0.756,0500000US15007,Kauai County,73298,7394,65904,50314,22194,352,156,20504,6825,283,15590,0.766,0.009,0.012,0.9%,1.2%
0500000US15009,15009,15,9,"Maui County, Hawaii",154834,15710,139124,109278,49193,818,380,43384,15257,246,29846,0.763,0500000US15009,Maui County,164754,16914,147840,116408,51926,1010,400,43284,18966,822,31432,0.771,0.008,0.011,0.8%,1.1%
0500000US16001,16001,16,1,"Ada County, Idaho",392365,27905,364460,356126,339332,4180,2058,9234,817,505,8334,0.246,0500000US16001,Ada County,494967,45223,449744,425355,397998,7733,2269,13651,1219,2485,24389,0.342,0.096,0.390,9.6%,39.0%
0500000US16003,16003,16,3,"Adams County, Idaho",3976,94,3882,3828,3768,4,36,16,2,2,54,0.101,0500000US16003,Adams County,4379,152,4227,4048,3992,3,27,8,0,18,179,0.166,0.065,0.643,6.5%,64.3%
0500000US16005,16005,16,5,"Bannock County, Idaho",82839,5587,77252,75757,71566,591,2301,1060,170,69,1495,0.248,0500000US16005,Bannock County,87018,7993,79025,75503,70447,688,2600,1148,249,371,3522,0.333,0.086,0.345,8.6%,34.5%
0500000US16007,16007,16,7,"Bear Lake County, Idaho",5986,216,5770,5726,5671,6,21,22,1,5,44,0.101,0500000US16007,Bear Lake County,6372,208,6164,6027,5977,10,25,13,2,0,137,0.119,0.017,0.173,1.7%,17.3%
0500000US16009,16009,16,9,"Benewah County, Idaho",9285,235,9050,8746,7919,25,765,27,6,4,304,0.264,0500000US16009,Benewah County,9530,254,9276,8692,7773,8,796,30,15,70,584,0.323,0.059,0.224,5.9%,22.4%
0500000US16011,16011,16,11,"Bingham County, Idaho",45607,7864,37743,37195,34176,78,2560,268,32,81,548,0.405,0500000US16011,Bingham County,47992,8331,39661,38312,34937,115,2892,192,38,138,1349,0.435,0.030,0.074,3.0%,7.4%
0500000US16013,16013,16,13,"Blaine County, Idaho",21376,4272,17104,16941,16669,23,44,174,14,17,163,0.352,0500000US16013,Blaine County,24272,5021,19251,18445,18024,45,34,211,15,116,806,0.405,0.053,0.150,5.3%,15.0%
0500000US16015,16015,16,15,"Boise County, Idaho",7028,249,6779,6644,6552,13,45,29,5,0,135,0.129,0500000US16015,Boise County,7610,324,7286,6949,6751,19,55,36,4,84,337,0.209,0.080,0.618,8.0%,61.8%
0500000US16017,16017,16,17,"Bonner County, Idaho",40877,911,39966,39199,38606,51,290,177,40,35,767,0.107,0500000US16017,Bonner County,47110,1504,45606,43352,42344,115,307,252,39,295,2254,0.189,0.082,0.762,8.2%,76.2%
0500000US16019,16019,16,19,"Bonneville County, Idaho",104234,11912,92322,90953,88873,533,554,841,81,71,1369,0.260,0500000US16019,Bonneville County,123964,17094,106870,103145,99943,593,677,1392,145,395,3725,0.330,0.070,0.270,7.0%,27.0%
0500000US16021,16021,16,21,"Boundary County, Idaho",10972,402,10570,10374,10110,29,167,56,6,6,196,0.149,0500000US16021,Boundary County,12056,692,11364,10874,10550,27,145,72,9,71,490,0.229,0.080,0.537,8.0%,53.7%
0500000US16023,16023,16,23,"Butte County, Idaho",2891,119,2772,2739,2713,5,11,5,5,0,33,0.118,0500000US16023,Butte County,2574,134,2440,2360,2336,2,15,3,2,2,80,0.173,0.055,0.469,5.5%,46.9%
0500000US16025,16025,16,25,"Camas County, Idaho",1117,75,1042,1017,1008,2,6,1,0,0,25,0.181,0500000US16025,Camas County,1077,59,1018,953,938,2,0,8,0,5,65,0.235,0.054,0.300,5.4%,30.0%
0500000US16027,16027,16,27,"Canyon County, Idaho",188923,45069,143854,140642,136553,877,1229,1402,369,212,3212,0.420,0500000US16027,Canyon County,231105,59166,171939,161745,155401,1455,1176,1973,620,1120,10194,0.480,0.060,0.143,6.0%,14.3%
0500000US16029,16029,16,29,"Caribou County, Idaho",6963,336,6627,6537,6481,4,19,14,15,4,90,0.131,0500000US16029,Caribou County,7027,384,6643,6475,6391,0,46,9,15,14,168,0.169,0.038,0.290,3.8%,29.0%
0500000US16031,16031,16,31,"Cassia County, Idaho",22952,5724,17228,17023,16742,38,106,104,15,18,205,0.406,0500000US16031,Cassia County,24655,7186,17469,16948,16522,64,122,131,29,80,521,0.465,0.060,0.148,6.0%,14.8%
0500000US16033,16033,16,33,"Clark County, Idaho",982,398,584,573,558,2,6,5,0,2,11,0.513,0500000US16033,Clark County,790,288,502,471,463,3,2,1,0,2,31,0.522,0.009,0.018,0.9%,1.8%
0500000US16035,16035,16,35,"Clearwater County, Idaho",8761,268,8493,8338,8063,16,184,61,9,5,155,0.151,0500000US16035,Clearwater County,8734,300,8434,8137,7882,40,133,45,2,35,297,0.183,0.032,0.210,3.2%,21.0%
0500000US16037,16037,16,37,"Custer County, Idaho",4368,176,4192,4153,4108,5,26,10,4,0,39,0.114,0500000US16037,Custer County,4275,156,4119,3963,3893,3,32,15,1,19,156,0.168,0.054,0.477,5.4%,47.7%
0500000US16039,16039,16,39,"Elmore County, Idaho",27038,4118,22920,22126,20305,696,224,748,101,52,794,0.410,0500000US16039,Elmore County,28666,5097,23569,21930,19996,688,234,766,101,145,1639,0.477,0.067,0.162,6.7%,16.2%
0500000US16041,16041,16,41,"Franklin County, Idaho",12786,838,11948,11827,11743,28,33,15,7,1,121,0.152,0500000US16041,Franklin County,14194,1023,13171,12853,12701,22,75,28,7,20,318,0.194,0.041,0.273,4.1%,27.3%
0500000US16043,16043,16,43,"Fremont County, Idaho",13242,1694,11548,11430,11273,24,86,27,11,9,118,0.259,0500000US16043,Fremont County,13388,1590,11798,11483,11292,21,68,44,24,34,315,0.274,0.015,0.058,1.5%,5.8%
0500000US16045,16045,16,45,"Gem County, Idaho",16719,1336,15383,15096,14898,20,77,78,10,13,287,0.199,0500000US16045,Gem County,19123,1722,17401,16500,16132,29,124,99,20,96,901,0.278,0.079,0.395,7.9%,39.5%
0500000US16047,16047,16,47,"Gooding County, Idaho",15464,4344,11120,10938,10758,13,86,60,10,11,182,0.437,0500000US16047,Gooding County,15598,4847,10751,10230,10044,20,70,40,4,52,521,0.488,0.051,0.116,5.1%,11.6%
0500000US16049,16049,16,49,"Idaho County, Idaho",16267,421,15846,15592,15028,38,446,65,6,9,254,0.145,0500000US16049,Idaho County,16541,611,15930,15278,14656,54,414,55,5,94,652,0.211,0.066,0.459,6.6%,45.9%
0500000US16051,16051,16,51,"Jefferson County, Idaho",26140,2641,23499,23241,22925,40,132,103,22,19,258,0.221,0500000US16051,Jefferson County,30891,3256,27635,26884,26430,73,127,118,30,106,751,0.256,0.036,0.162,3.6%,16.2%
0500000US16053,16053,16,53,"Jerome County, Idaho",22374,6929,15445,15248,14958,39,156,62,12,21,197,0.457,0500000US16053,Jerome County,24237,9176,15061,14474,14153,39,110,80,22,70,587,0.515,0.058,0.127,5.8%,12.7%
0500000US16055,16055,16,55,"Kootenai County, Idaho",138494,5268,133226,130564,127454,381,1570,925,117,117,2662,0.151,0500000US16055,Kootenai County,171362,8756,162606,153778,149107,463,1715,1371,195,927,8828,0.237,0.086,0.571,8.6%,57.1%
0500000US16057,16057,16,57,"Latah County, Idaho",37244,1326,35918,35116,33746,288,218,773,45,46,802,0.177,0500000US16057,Latah County,39517,2073,37444,35300,33476,318,263,968,48,227,2144,0.276,0.099,0.561,9.9%,56.1%
0500000US16059,16059,16,59,"Lemhi County, Idaho",7936,181,7755,7641,7543,16,49,29,3,1,114,0.096,0500000US16059,Lemhi County,7974,295,7679,7415,7280,17,46,28,6,38,264,0.164,0.068,0.711,6.8%,71.1%
0500000US16061,16061,16,61,"Lewis County, Idaho",3821,128,3693,3606,3398,14,176,12,5,1,87,0.205,0500000US16061,Lewis County,3533,138,3395,3238,3031,6,181,7,1,12,157,0.258,0.052,0.256,5.2%,25.6%
0500000US16063,16063,16,63,"Lincoln County, Idaho",5208,1476,3732,3680,3607,18,30,18,3,4,52,0.440,0500000US16063,Lincoln County,5127,1639,3488,3292,3245,6,22,10,4,5,196,0.496,0.056,0.127,5.6%,12.7%
0500000US16065,16065,16,65,"Madison County, Idaho",37536,2218,35318,34919,34218,178,81,348,51,43,399,0.165,0500000US16065,Madison County,52913,5248,47665,46160,43985,709,153,933,215,165,1505,0.298,0.133,0.802,13.3%,80.2%
0500000US16067,16067,16,67,"Minidoka County, Idaho",20069,6493,13576,13377,13095,44,146,70,1,21,199,0.469,0500000US16067,Minidoka County,21613,7909,13704,13183,12946,27,92,51,10,57,521,0.507,0.037,0.079,3.7%,7.9%
0500000US16069,16069,16,69,"Nez Perce County, Idaho",39265,1109,38156,37346,34835,112,2074,277,35,13,810,0.209,0500000US16069,Nez Perce County,42090,1630,40460,38438,35436,184,2336,324,32,126,2022,0.284,0.075,0.361,7.5%,36.1%
0500000US16071,16071,16,71,"Oneida County, Idaho",4286,126,4160,4125,4073,9,21,20,1,1,35,0.096,0500000US16071,Oneida County,4564,178,4386,4301,4259,2,14,14,4,8,85,0.127,0.031,0.327,3.1%,32.7%
0500000US16073,16073,16,73,"Owyhee County, Idaho",11526,2979,8547,8388,7867,18,432,56,1,14,159,0.466,0500000US16073,Owyhee County,11913,2915,8998,8580,8060,28,374,42,8,68,418,0.480,0.014,0.031,1.4%,3.1%
0500000US16075,16075,16,75,"Payette County, Idaho",22623,3363,19260,18831,18388,41,185,187,15,15,429,0.317,0500000US16075,Payette County,25386,4268,21118,19826,19240,52,163,207,31,133,1292,0.395,0.078,0.246,7.8%,24.6%
0500000US16077,16077,16,77,"Power County, Idaho",7817,2328,5489,5383,5164,18,161,32,6,2,106,0.474,0500000US16077,Power County,7878,2624,5254,5063,4826,17,172,18,8,22,191,0.513,0.038,0.081,3.8%,8.1%
0500000US16079,16079,16,79,"Shoshone County, Idaho",12765,380,12385,12181,11929,20,177,44,5,6,204,0.125,0500000US16079,Shoshone County,13169,450,12719,12073,11771,15,145,53,6,83,646,0.197,0.072,0.574,7.2%,57.4%
0500000US16081,16081,16,81,"Teton County, Idaho",10170,1721,8449,8388,8286,12,27,48,12,3,61,0.307,0500000US16081,Teton County,11630,2020,9610,9270,9141,16,25,51,0,37,340,0.351,0.044,0.142,4.4%,14.2%
0500000US16083,16083,16,83,"Twin Falls County, Idaho",77230,10570,66660,65615,63841,307,428,895,79,65,1045,0.298,0500000US16083,Twin Falls County,90046,15210,74836,71560,68169,1021,499,1403,201,267,3276,0.397,0.099,0.333,9.9%,33.3%
0500000US16085,16085,16,85,"Valley County, Idaho",9862,386,9476,9370,9277,9,38,41,1,4,106,0.113,0500000US16085,Valley County,11746,601,11145,10678,10467,16,54,55,8,78,467,0.202,0.088,0.777,8.8%,77.7%
0500000US16087,16087,16,87,"Washington County, Idaho",10198,1716,8482,8356,8166,10,75,90,3,12,126,0.330,0500000US16087,Washington County,10500,1662,8838,8350,8118,17,74,81,7,53,488,0.375,0.045,0.135,4.5%,13.5%
0500000US17001,17001,17,1,"Adams County, Illinois",67103,776,66327,65319,62414,2288,100,430,12,75,1008,0.133,0500000US17001,Adams County,65737,1287,64450,61701,58389,2464,92,500,33,223,2749,0.207,0.074,0.556,7.4%,55.6%
0500000US17003,17003,17,3,"Alexander County, Illinois",8238,155,8083,7943,4983,2908,25,16,6,5,140,0.509,0500000US17003,Alexander County,5240,82,5158,4922,3274,1612,22,6,0,8,236,0.513,0.004,0.008,0.4%,0.8%
0500000US17005,17005,17,5,"Bond County, Illinois",17768,547,17221,17011,15797,1061,76,67,3,7,210,0.205,0500000US17005,Bond County,16725,604,16121,15587,14264,1073,52,94,11,93,534,0.266,0.061,0.299,6.1%,29.9%
0500000US17007,17007,17,7,"Boone County, Illinois",54165,10967,43198,42532,40757,976,68,667,15,49,666,0.392,0500000US17007,Boone County,53448,12880,40568,38759,36689,1171,72,637,9,181,1809,0.469,0.077,0.196,7.7%,19.6%
0500000US17009,17009,17,9,"Brown County, Illinois",6937,402,6535,6500,5191,1275,10,16,2,6,35,0.403,0500000US17009,Brown County,6244,282,5962,5819,4764,1035,7,11,0,2,143,0.388,-0.015,-0.037,-1.5%,-3.7%
0500000US17011,17011,17,11,"Bureau County, Illinois",34978,2695,32283,31957,31473,191,63,220,6,4,326,0.184,0500000US17011,Bureau County,33244,3095,30149,29189,28511,259,49,298,21,51,960,0.255,0.071,0.383,7.1%,38.3%
0500000US17013,17013,17,13,"Calhoun County, Illinois",5089,40,5049,5031,5001,6,9,12,0,3,18,0.034,0500000US17013,Calhoun County,4437,64,4373,4241,4217,7,4,7,0,6,132,0.096,0.061,1.795,6.1%,179.5%
0500000US17015,17015,17,15,"Carroll County, Illinois",15387,437,14950,14811,14596,122,35,53,2,3,139,0.099,0500000US17015,Carroll County,15702,757,14945,14545,13743,676,49,40,5,32,400,0.229,0.130,1.310,13.0%,131.0%
0500000US17017,17017,17,17,"Cass County, Illinois",13642,2291,11351,11273,10830,379,15,43,1,5,78,0.341,0500000US17017,Cass County,13042,2789,10253,9963,9061,706,36,117,33,10,290,0.468,0.127,0.374,12.7%,37.4%
0500000US17019,17019,17,19,"Champaign County, Illinois",201081,10607,190474,185778,142470,24553,360,17879,129,387,4696,0.472,0500000US17019,Champaign County,205865,16666,189199,179151,125280,28215,279,24420,60,897,10048,0.588,0.116,0.246,11.6%,24.6%
0500000US17021,17021,17,21,"Christian County, Illinois",34800,471,34329,34045,33331,492,41,165,7,9,284,0.082,0500000US17021,Christian County,34032,1094,32938,31905,31226,380,59,179,1,60,1033,0.156,0.074,0.898,7.4%,89.8%
0500000US17023,17023,17,23,"Clark County, Illinois",16335,172,16163,16057,15925,48,24,54,3,3,106,0.049,0500000US17023,Clark County,15455,246,15209,14844,14680,54,28,52,0,30,365,0.097,0.048,0.962,4.8%,96.2%
0500000US17025,17025,17,25,"Clay County, Illinois",13815,151,13664,13565,13429,43,30,63,0,0,99,0.055,0500000US17025,Clay County,13288,223,13065,12639,12481,30,33,77,0,18,426,0.116,0.062,1.121,6.2%,112.1%
0500000US17027,17027,17,27,"Clinton County, Illinois",37762,1058,36704,36364,34766,1323,80,167,11,17,340,0.150,0500000US17027,Clinton County,36899,1387,35512,34338,32845,1140,80,175,5,93,1174,0.204,0.054,0.359,5.4%,35.9%
0500000US17029,17029,17,29,"Coles County, Illinois",53873,1155,52718,52001,49330,2022,79,523,10,37,717,0.159,0500000US17029,Coles County,46863,1768,45095,43329,40352,2043,82,617,24,211,1766,0.254,0.094,0.591,9.4%,59.1%
0500000US17031,17031,17,31,"Cook County, Illinois",5194675,1244762,3949913,3878481,2278358,1265778,6682,318869,1043,7751,71432,0.687,0500000US17031,Cook County,5275541,1382778,3892763,3756689,2135243,1185601,5655,408691,961,20538,136074,0.710,0.023,0.034,2.3%,3.4%
0500000US17033,17033,17,33,"Crawford County, Illinois",19817,362,19455,19295,18216,923,42,100,7,7,160,0.152,0500000US17033,Crawford County,18679,447,18232,17692,16941,608,36,76,2,29,540,0.175,0.022,0.148,2.2%,14.8%
0500000US17035,17035,17,35,"Cumberland County, Illinois",11048,75,10973,10896,10815,35,17,25,0,4,77,0.042,0500000US17035,Cumberland County,10450,112,10338,10026,9947,28,13,21,0,17,312,0.093,0.051,1.233,5.1%,123.3%
0500000US17037,17037,17,37,"DeKalb County, Illinois",105160,10647,94513,93064,83825,6579,127,2400,19,114,1449,0.350,0500000US17037,DeKalb County,100420,13597,86823,82705,71249,8730,119,2280,29,298,4118,0.468,0.119,0.340,11.9%,34.0%
0500000US17039,17039,17,39,"De Witt County, Illinois",16561,354,16207,16048,15855,82,23,58,4,26,159,0.083,0500000US17039,De Witt County,15516,510,15006,14569,14370,108,19,40,16,16,437,0.140,0.057,0.694,5.7%,69.4%
0500000US17041,17041,17,41,"Douglas County, Illinois",19980,1210,18770,18599,18427,53,31,82,0,6,171,0.146,0500000US17041,Douglas County,19740,1565,18175,17658,17420,67,28,103,6,34,517,0.214,0.069,0.471,6.9%,47.1%
0500000US17043,17043,17,43,"DuPage County, Illinois",916924,121506,795418,781291,646130,41024,992,91793,171,1181,14127,0.474,0500000US17043,DuPage County,932877,144291,788586,759015,591441,44201,873,118982,219,3299,29571,0.555,0.081,0.171,8.1%,17.1%
0500000US17045,17045,17,45,"Edgar County, Illinois",18576,187,18389,18266,18142,63,23,33,3,2,123,0.046,0500000US17045,Edgar County,16866,225,16641,16188,16005,82,17,51,0,33,453,0.099,0.053,1.142,5.3%,114.2%
0500000US17047,17047,17,47,"Edwards County, Illinois",6721,59,6662,6615,6555,30,8,21,0,1,47,0.049,0500000US17047,Edwards County,6245,63,6182,6054,5994,16,8,21,4,11,128,0.078,0.030,0.609,3.0%,60.9%
0500000US17049,17049,17,49,"Effingham County, Illinois",34242,597,33645,33422,33155,76,24,147,7,13,223,0.062,0500000US17049,Effingham County,34668,872,33796,32845,32361,151,36,246,6,45,951,0.127,0.065,1.048,6.5%,104.8%
0500000US17051,17051,17,51,"Fayette County, Illinois",22140,304,21836,21644,20585,969,33,47,4,6,192,0.133,0500000US17051,Fayette County,21488,657,20831,20384,19425,780,80,67,1,31,447,0.180,0.047,0.350,4.7%,35.0%
0500000US17053,17053,17,53,"Ford County, Illinois",14081,294,13787,13677,13520,78,32,36,0,11,110,0.078,0500000US17053,Ford County,13534,554,12980,12463,12265,75,24,57,0,42,517,0.176,0.098,1.263,9.8%,126.3%
0500000US17055,17055,17,55,"Franklin County, Illinois",39561,475,39086,38701,38353,118,92,122,3,13,385,0.060,0500000US17055,Franklin County,37804,642,37162,35650,35210,162,92,119,4,63,1512,0.131,0.071,1.181,7.1%,118.1%
0500000US17057,17057,17,57,"Fulton County, Illinois",37069,896,36173,35874,34397,1268,82,111,2,14,299,0.137,0500000US17057,Fulton County,33609,738,32871,31929,30616,1102,59,69,6,77,942,0.168,0.031,0.224,3.1%,22.4%
0500000US17059,17059,17,59,"Gallatin County, Illinois",5589,66,5523,5459,5427,12,14,5,0,1,64,0.057,0500000US17059,Gallatin County,4946,53,4893,4739,4683,25,5,23,0,3,154,0.102,0.046,0.801,4.6%,80.1%
0500000US17061,17061,17,61,"Greene County, Illinois",13886,115,13771,13678,13517,119,20,16,2,4,93,0.052,0500000US17061,Greene County,11985,106,11879,11529,11451,18,13,21,3,23,350,0.086,0.034,0.649,3.4%,64.9%
0500000US17063,17063,17,63,"Grundy County, Illinois",50063,4096,45967,45526,44526,577,68,318,12,25,441,0.202,0500000US17063,Grundy County,52533,5712,46821,44957,43472,833,48,466,16,122,1864,0.302,0.100,0.494,10.0%,49.4%
0500000US17065,17065,17,65,"Hamilton County, Illinois",8457,105,8352,8294,8234,31,10,19,0,0,58,0.052,0500000US17065,Hamilton County,7993,96,7897,7639,7574,36,16,12,0,1,258,0.101,0.049,0.947,4.9%,94.7%
0500000US17067,17067,17,67,"Hancock County, Illinois",19104,185,18919,18764,18611,51,34,45,11,12,155,0.051,0500000US17067,Hancock County,17620,318,17302,16800,16599,73,38,57,4,29,502,0.111,0.061,1.193,6.1%,119.3%
0500000US17069,17069,17,69,"Hardin County, Illinois",4320,56,4264,4237,4171,13,26,22,5,0,27,0.068,0500000US17069,Hardin County,3649,65,3584,3408,3374,11,0,17,2,4,176,0.142,0.075,1.109,7.5%,110.9%
0500000US17071,17071,17,71,"Henderson County, Illinois",7331,79,7252,7186,7133,15,15,15,5,3,66,0.053,0500000US17071,Henderson County,6387,112,6275,6113,6060,29,5,14,5,0,162,0.099,0.046,0.861,4.6%,86.1%
0500000US17073,17073,17,73,"Henry County, Illinois",50486,2402,48084,47523,46493,762,60,183,13,12,561,0.149,0500000US17073,Henry County,49284,3170,46114,44484,43094,1029,63,192,12,94,1630,0.230,0.080,0.539,8.0%,53.9%
0500000US17075,17075,17,75,"Iroquois County, Illinois",29718,1584,28134,27849,27467,233,42,102,1,4,285,0.143,0500000US17075,Iroquois County,27077,2085,24992,23999,23602,212,38,99,0,48,993,0.233,0.090,0.631,9.0%,63.1%
0500000US17077,17077,17,77,"Jackson County, Illinois",60218,2403,57815,56439,45746,8488,176,1890,28,111,1376,0.400,0500000US17077,Jackson County,52974,2837,50137,47441,37513,7503,114,2048,24,239,2696,0.471,0.072,0.179,7.2%,17.9%
0500000US17079,17079,17,79,"Jasper County, Illinois",9698,79,9619,9566,9517,10,12,24,2,1,53,0.037,0500000US17079,Jasper County,9287,84,9203,9013,8934,22,19,15,4,19,190,0.074,0.037,1.008,3.7%,100.8%
0500000US17081,17081,17,81,"Jefferson County, Illinois",38827,799,38028,37479,33919,3194,69,246,7,44,549,0.229,0500000US17081,Jefferson County,37113,899,36214,34469,31182,2783,77,352,7,68,1745,0.286,0.056,0.245,5.6%,24.5%
0500000US17083,17083,17,83,"Jersey County, Illinois",22985,222,22763,22515,22281,89,52,76,6,11,248,0.060,0500000US17083,Jersey County,21512,327,21185,20391,20105,156,21,74,3,32,794,0.125,0.065,1.078,6.5%,107.8%
0500000US17085,17085,17,85,"Jo Daviess County, Illinois",22678,609,22069,21895,21681,100,29,72,7,6,174,0.085,0500000US17085,Jo Daviess County,22035,856,21179,20653,20354,114,31,96,6,52,526,0.145,0.059,0.698,5.9%,69.8%
0500000US17087,17087,17,87,"Johnson County, Illinois",12582,376,12206,12105,11056,1004,19,21,1,4,101,0.221,0500000US17087,Johnson County,13308,552,12756,12368,10895,1419,20,18,4,12,388,0.316,0.095,0.432,9.5%,43.2%
0500000US17089,17089,17,89,"Kane County, Illinois",515269,158390,356879,350618,304051,27819,591,17505,130,522,6261,0.553,0500000US17089,Kane County,516522,169595,346927,331887,282307,26239,514,21191,115,1521,15040,0.588,0.035,0.064,3.5%,6.4%
0500000US17091,17091,17,91,"Kankakee County, Illinois",113449,10167,103282,101568,83218,16998,187,1030,32,103,1714,0.431,0500000US17091,Kankakee County,107502,12520,94982,90635,73591,15417,173,1069,13,372,4347,0.496,0.064,0.149,6.4%,14.9%
0500000US17093,17093,17,93,"Kendall County, Illinois",114736,17898,96838,95150,85156,6343,129,3403,28,91,1688,0.421,0500000US17093,Kendall County,131869,27127,104742,99622,84690,9693,117,4625,10,487,5120,0.537,0.116,0.277,11.6%,27.7%
0500000US17095,17095,17,95,"Knox County, Illinois",52919,2558,50361,49330,45132,3741,75,331,7,44,1031,0.265,0500000US17095,Knox County,49967,3051,46916,44622,39615,4354,73,361,12,207,2294,0.358,0.093,0.351,9.3%,35.1%
0500000US17097,17097,17,97,"Lake County, Illinois",703462,139987,563475,552477,458701,46989,1058,43954,228,1547,10998,0.527,0500000US17097,Lake County,714342,171962,542380,518975,408349,47240,909,58901,312,3264,23405,0.603,0.076,0.145,7.6%,14.5%
0500000US17099,17099,17,99,"LaSalle County, Illinois",113924,9135,104789,103661,100545,2104,200,755,13,44,1128,0.214,0500000US17099,LaSalle County,109658,11456,98202,94272,90445,2514,153,855,8,297,3930,0.307,0.093,0.433,9.3%,43.3%
0500000US17101,17101,17,101,"Lawrence County, Illinois",16833,553,16280,16151,14491,1583,30,38,1,8,129,0.249,0500000US17101,Lawrence County,15280,514,14766,14276,12777,1393,12,58,7,29,490,0.290,0.041,0.166,4.1%,16.6%
0500000US17103,17103,17,103,"Lee County, Illinois",36031,1802,34229,33859,31824,1709,51,244,6,25,370,0.215,0500000US17103,Lee County,34145,2324,31821,30649,28435,1831,30,248,10,95,1172,0.298,0.083,0.385,8.3%,38.5%
0500000US17105,17105,17,105,"Livingston County, Illinois",38950,1532,37418,37068,34903,1887,51,197,1,29,350,0.193,0500000US17105,Livingston County,35815,1859,33956,32898,31518,1081,38,171,1,89,1058,0.221,0.028,0.145,2.8%,14.5%
0500000US17107,17107,17,107,"Logan County, Illinois",30305,893,29412,29084,26586,2243,54,184,5,12,328,0.224,0500000US17107,Logan County,27987,818,27169,26249,24452,1494,48,178,1,76,920,0.232,0.008,0.036,0.8%,3.6%
0500000US17109,17109,17,109,"McDonough County, Illinois",32612,867,31745,31226,28979,1594,52,572,2,27,519,0.207,0500000US17109,McDonough County,27238,962,26276,25246,23062,1498,47,560,6,73,1030,0.277,0.070,0.340,7.0%,34.0%
0500000US17111,17111,17,111,"McHenry County, Illinois",308760,35249,273511,270074,258584,3045,455,7712,68,210,3437,0.285,0500000US17111,McHenry County,310229,46705,263524,252643,238659,4073,325,8669,45,872,10881,0.383,0.099,0.346,9.9%,34.6%
0500000US17113,17113,17,113,"McLean County, Illinois",169572,7434,162138,158802,138835,12246,290,7180,48,203,3336,0.320,0500000US17113,McLean County,170954,10524,160430,153161,129440,14699,258,8108,38,618,7269,0.411,0.091,0.284,9.1%,28.4%
0500000US17115,17115,17,115,"Macon County, Illinois",110768,2072,108696,106215,86822,17916,199,1107,26,145,2481,0.359,0500000US17115,Macon County,103998,2733,101265,96139,75117,18886,178,1512,31,415,5126,0.442,0.083,0.233,8.3%,23.3%
0500000US17117,17117,17,117,"Macoupin County, Illinois",47765,418,47347,46953,46315,359,110,129,8,32,394,0.060,0500000US17117,Macoupin County,44967,570,44397,42560,41850,368,109,179,0,54,1837,0.132,0.072,1.214,7.2%,121.4%
0500000US17119,17119,17,119,"Madison County, Illinois",269282,7313,261969,257646,233515,21066,556,2211,92,206,4323,0.241,0500000US17119,Madison County,265859,10797,255062,242658,213793,24671,559,2718,92,825,12404,0.341,0.100,0.415,10.0%,41.5%
0500000US17121,17121,17,121,"Marion County, Illinois",39437,542,38895,38341,36456,1536,105,224,9,11,554,0.144,0500000US17121,Marion County,37729,712,37017,35200,33150,1509,94,349,1,97,1817,0.224,0.080,0.558,8.0%,55.8%
0500000US17123,17123,17,123,"Marshall County, Illinois",12640,314,12326,12237,12128,44,17,43,2,3,89,0.079,0500000US17123,Marshall County,11742,323,11419,11030,10858,86,18,43,0,25,389,0.143,0.064,0.817,6.4%,81.7%
0500000US17125,17125,17,125,"Mason County, Illinois",14666,117,14549,14423,14296,53,31,40,0,3,126,0.050,0500000US17125,Mason County,13086,184,12902,12450,12339,49,24,26,1,11,452,0.109,0.060,1.205,6.0%,120.5%
0500000US17127,17127,17,127,"Massac County, Illinois",15429,290,15139,14863,13860,891,59,41,0,12,276,0.189,0500000US17127,Massac County,14169,333,13836,13097,12077,875,35,43,6,61,739,0.266,0.077,0.409,7.7%,40.9%
0500000US17129,17129,17,129,"Menard County, Illinois",12705,121,12584,12455,12320,74,27,29,1,4,129,0.059,0500000US17129,Menard County,12297,160,12137,11676,11502,80,18,49,2,25,461,0.123,0.064,1.077,6.4%,107.7%
0500000US17131,17131,17,131,"Mercer County, Illinois",16434,307,16127,16031,15912,46,15,51,1,6,96,0.062,0500000US17131,Mercer County,15699,468,15231,14728,14578,68,26,37,2,17,503,0.136,0.074,1.186,7.4%,118.6%
0500000US17133,17133,17,133,"Monroe County, Illinois",32957,450,32507,32268,31991,64,57,142,6,8,239,0.057,0500000US17133,Monroe County,34962,646,34316,33105,32680,118,53,186,2,66,1211,0.125,0.067,1.169,6.7%,116.9%
0500000US17135,17135,17,135,"Montgomery County, Illinois",30104,459,29645,29460,28334,949,45,111,11,10,185,0.113,0500000US17135,Montgomery County,28288,587,27701,26838,25709,916,49,131,7,26,863,0.172,0.059,0.520,5.9%,52.0%
0500000US17137,17137,17,137,"Morgan County, Illinois",35547,712,34835,34319,31937,2104,67,163,6,42,516,0.189,0500000US17137,Morgan County,32915,838,32077,30870,28489,1961,54,266,16,84,1207,0.245,0.057,0.300,5.7%,30.0%
0500000US17139,17139,17,139,"Moultrie County, Illinois",14846,129,14717,14634,14524,40,28,29,0,13,83,0.043,0500000US17139,Moultrie County,14526,194,14332,13931,13747,84,26,49,0,25,401,0.103,0.061,1.416,6.1%,141.6%
0500000US17141,17141,17,141,"Ogle County, Illinois",53497,4741,48756,48249,47425,468,91,241,5,19,507,0.206,0500000US17141,Ogle County,51788,5797,45991,44098,43120,543,72,259,0,104,1893,0.293,0.087,0.420,8.7%,42.0%
0500000US17143,17143,17,143,"Peoria County, Illinois",186494,7102,179392,174905,135620,32720,373,5819,59,314,4487,0.437,0500000US17143,Peoria County,181830,10091,171739,163180,120629,33635,342,7730,61,783,8559,0.519,0.081,0.186,8.1%,18.6%
0500000US17145,17145,17,145,"Perry County, Illinois",22350,599,21751,21473,19463,1856,43,87,8,16,278,0.234,0500000US17145,Perry County,20945,714,20231,19626,17779,1653,34,125,1,34,605,0.271,0.037,0.160,3.7%,16.0%
0500000US17147,17147,17,147,"Piatt County, Illinois",16729,167,16562,16427,16276,56,28,49,6,12,135,0.053,0500000US17147,Piatt County,16673,247,16426,15838,15600,83,23,80,1,51,588,0.123,0.070,1.311,7.0%,131.1%
0500000US17149,17149,17,149,"Pike County, Illinois",16430,172,16258,16146,15802,274,24,38,4,4,112,0.075,0500000US17149,Pike County,14739,262,14477,14039,13874,63,33,43,6,20,438,0.113,0.038,0.512,3.8%,51.2%
0500000US17151,17151,17,151,"Pope County, Illinois",4470,64,4406,4367,4055,269,28,11,1,3,39,0.173,0500000US17151,Pope County,3763,71,3692,3546,3491,38,1,16,0,0,146,0.137,-0.036,-0.207,-3.6%,-20.7%
0500000US17153,17153,17,153,"Pulaski County, Illinois",6161,97,6064,5968,3937,1976,25,13,3,14,96,0.488,0500000US17153,Pulaski County,5193,204,4989,4770,3245,1462,36,13,0,14,219,0.527,0.039,0.079,3.9%,7.9%
0500000US17155,17155,17,155,"Putnam County, Illinois",6006,252,5754,5705,5654,31,5,13,1,1,49,0.112,0500000US17155,Putnam County,5637,348,5289,5136,5073,26,7,18,4,8,153,0.186,0.074,0.658,7.4%,65.8%
0500000US17157,17157,17,157,"Randolph County, Illinois",33476,867,32609,32347,28933,3245,43,102,9,15,262,0.243,0500000US17157,Randolph County,30163,1031,29132,28054,25460,2381,48,86,7,72,1078,0.279,0.036,0.148,3.6%,14.8%
0500000US17159,17159,17,159,"Richland County, Illinois",16233,205,16028,15898,15673,78,25,117,1,4,130,0.068,0500000US17159,Richland County,15813,273,15540,15068,14813,75,28,123,7,22,472,0.121,0.054,0.795,5.4%,79.5%
0500000US17161,17161,17,161,"Rock Island County, Illinois",147546,17118,130428,127520,111764,12911,283,2383,44,135,2908,0.404,0500000US17161,Rock Island County,144672,19842,124830,118648,97689,16169,240,4033,35,482,6182,0.510,0.106,0.261,10.6%,26.1%
0500000US17163,17163,17,163,"St. Clair County, Illinois",270056,8785,261271,256044,169858,81860,539,3213,213,361,5227,0.511,0500000US17163,St. Clair County,257400,12582,244818,231955,150496,76013,490,3623,181,1152,12863,0.566,0.055,0.107,5.5%,10.7%
0500000US17165,17165,17,165,"Saline County, Illinois",24913,340,24573,24188,23011,974,84,100,9,10,385,0.145,0500000US17165,Saline County,23768,473,23295,22286,21309,692,69,122,0,94,1009,0.193,0.048,0.333,4.8%,33.3%
0500000US17167,17167,17,167,"Sangamon County, Illinois",197465,3480,193985,190026,162987,23146,343,3198,44,308,3959,0.304,0500000US17167,Sangamon County,196343,5309,191034,181584,150467,25686,349,4300,55,727,9450,0.392,0.088,0.290,8.8%,29.0%
0500000US17169,17169,17,169,"Schuyler County, Illinois",7544,90,7454,7426,7163,240,12,9,0,2,28,0.097,0500000US17169,Schuyler County,6902,152,6750,6512,6157,283,28,25,2,17,238,0.201,0.104,1.064,10.4%,106.4%
0500000US17171,17171,17,171,"Scott County, Illinois",5355,43,5312,5274,5246,5,9,12,0,2,38,0.040,0500000US17171,Scott County,4949,48,4901,4770,4747,5,1,11,1,5,131,0.079,0.039,0.971,3.9%,97.1%
0500000US17173,17173,17,173,"Shelby County, Illinois",22363,180,22183,22074,21922,48,39,56,5,4,109,0.039,0500000US17173,Shelby County,20990,213,20777,20340,20116,65,35,83,1,40,437,0.081,0.042,1.079,4.2%,107.9%
0500000US17175,17175,17,175,"Stark County, Illinois",5994,59,5935,5883,5826,28,9,19,0,1,52,0.055,0500000US17175,Stark County,5400,132,5268,5123,5070,17,8,23,0,5,145,0.117,0.062,1.127,6.2%,112.7%
0500000US17177,17177,17,177,"Stephenson County, Illinois",47711,1406,46305,45258,40612,4226,68,295,13,44,1047,0.266,0500000US17177,Stephenson County,44630,2254,42376,40331,35405,4374,80,306,11,155,2045,0.356,0.090,0.339,9.0%,33.9%
0500000US17179,17179,17,179,"Tazewell County, Illinois",135394,2514,132880,131425,128625,1351,307,990,30,122,1455,0.097,0500000US17179,Tazewell County,131343,3161,128182,123235,119882,1629,279,1080,41,324,4947,0.165,0.068,0.700,6.8%,70.0%
0500000US17181,17181,17,181,"Union County, Illinois",17808,863,16945,16729,16454,151,59,52,5,8,216,0.144,0500000US17181,Union County,17244,867,16377,15709,15331,226,46,67,11,28,668,0.205,0.062,0.429,6.2%,42.9%
0500000US17183,17183,17,183,"Vermilion County, Illinois",81625,3441,78184,76745,65590,10394,138,559,12,52,1439,0.336,0500000US17183,Vermilion County,74188,3816,70372,67400,56186,10247,140,568,10,249,2972,0.403,0.067,0.200,6.7%,20.0%
0500000US17185,17185,17,185,"Wabash County, Illinois",11947,158,11789,11666,11498,73,17,63,5,10,123,0.073,0500000US17185,Wabash County,11361,178,11183,10860,10520,53,15,251,6,15,323,0.141,0.068,0.921,6.8%,92.1%
0500000US17187,17187,17,187,"Warren County, Illinois",17707,1490,16217,16012,15582,287,32,93,9,9,205,0.218,0500000US17187,Warren County,16835,1789,15046,14492,13494,577,31,329,15,46,554,0.344,0.125,0.575,12.5%,57.5%
0500000US17189,17189,17,189,"Washington County, Illinois",14716,197,14519,14415,14260,94,13,41,4,3,104,0.061,0500000US17189,Washington County,13761,224,13537,13186,12976,85,25,65,20,15,351,0.110,0.049,0.809,4.9%,80.9%
0500000US17191,17191,17,191,"Wayne County, Illinois",16760,176,16584,16479,16340,40,26,70,1,2,105,0.049,0500000US17191,Wayne County,16179,182,15997,15599,15400,90,26,49,5,29,398,0.093,0.044,0.890,4.4%,89.0%
0500000US17193,17193,17,193,"White County, Illinois",14665,158,14507,14423,14308,37,40,31,5,2,84,0.048,0500000US17193,White County,13877,188,13689,13218,13007,91,22,65,18,15,471,0.120,0.072,1.505,7.2%,150.5%
0500000US17195,17195,17,195,"Whiteside County, Illinois",58498,6455,52043,51364,50263,705,90,269,2,35,679,0.249,0500000US17195,Whiteside County,55691,7131,48560,46606,45341,741,60,306,9,149,1954,0.319,0.070,0.281,7.0%,28.1%
0500000US17197,17197,17,197,"Will County, Illinois",677560,105817,571743,562123,455577,74419,814,30458,104,751,9620,0.509,0500000US17197,Will County,696355,130851,565504,542988,418418,79256,711,42416,82,2105,22516,0.586,0.077,0.151,7.7%,15.1%
0500000US17199,17199,17,199,"Williamson County, Illinois",66357,1301,65056,64060,60719,2514,206,557,8,56,996,0.161,0500000US17199,Williamson County,67153,1779,65374,62219,58193,2809,230,771,9,207,3155,0.244,0.084,0.521,8.4%,52.1%
0500000US17201,17201,17,201,"Winnebago County, Illinois",295266,32177,263089,257219,214196,35358,563,6722,61,319,5870,0.447,0500000US17201,Winnebago County,285350,40952,244398,231137,183235,38240,559,7938,66,1099,13261,0.546,0.100,0.223,10.0%,22.3%
0500000US17203,17203,17,203,"Woodford County, Illinois",38664,527,38137,37771,37294,186,65,208,5,13,366,0.069,0500000US17203,Woodford County,38467,740,37727,36471,35844,269,42,217,10,89,1256,0.130,0.061,0.879,6.1%,87.9%
0500000US18001,18001,18,1,"Adams County, Indiana",34387,1412,32975,32783,32521,102,60,78,7,15,192,0.104,0500000US18001,Adams County,35809,1637,34172,33520,33080,171,80,135,4,50,652,0.144,0.040,0.388,4.0%,38.8%
0500000US18003,18003,18,3,"Allen County, Indiana",355329,23093,332236,324161,271789,40998,987,9611,119,657,8075,0.396,0500000US18003,Allen County,385410,32923,352487,334930,270149,43629,883,18191,138,1940,17557,0.484,0.088,0.222,8.8%,22.2%
0500000US18005,18005,18,5,"Bartholomew County, Indiana",76794,4762,72032,71080,66817,1360,145,2622,37,99,952,0.237,0500000US18005,Bartholomew County,82208,7257,74951,72013,64395,1768,132,5383,45,290,2938,0.373,0.135,0.569,13.5%,56.9%
0500000US18007,18007,18,7,"Benton County, Indiana",8854,431,8423,8365,8298,36,11,15,3,2,58,0.119,0500000US18007,Benton County,8719,629,8090,7896,7789,44,15,13,7,28,194,0.196,0.077,0.646,7.7%,64.6%
0500000US18009,18009,18,9,"Blackford County, Indiana",12766,117,12649,12505,12403,48,22,19,4,9,144,0.056,0500000US18009,Blackford County,12112,252,11860,11424,11278,54,38,24,0,30,436,0.131,0.075,1.350,7.5%,135.0%
0500000US18011,18011,18,11,"Boone County, Indiana",56640,1270,55370,54712,53151,484,91,941,10,35,658,0.118,0500000US18011,Boone County,70812,2775,68037,65338,61135,1426,128,2389,19,241,2699,0.250,0.132,1.112,13.2%,111.2%
0500000US18013,18013,18,13,"Brown County, Indiana",15242,178,15064,14918,14761,53,47,44,1,12,146,0.062,0500000US18013,Brown County,15475,270,15205,14666,14463,55,30,65,5,48,539,0.125,0.063,1.020,6.3%,102.0%
0500000US18015,18015,18,15,"Carroll County, Indiana",20155,711,19444,19297,19188,42,33,20,1,13,147,0.092,0500000US18015,Carroll County,20306,823,19483,18993,18727,128,33,48,0,57,490,0.147,0.055,0.594,5.5%,59.4%
0500000US18017,18017,18,17,"Cass County, Indiana",38966,4897,34069,33701,32624,519,100,407,3,48,368,0.283,0500000US18017,Cass County,37870,6675,31195,30070,28744,560,109,573,8,76,1125,0.391,0.109,0.384,10.9%,38.4%
0500000US18019,18019,18,19,"Clark County, Indiana",110232,5350,104882,102782,93887,7541,255,858,43,198,2100,0.267,0500000US18019,Clark County,121093,7891,113202,106840,95403,9265,249,1305,127,491,6362,0.366,0.099,0.371,9.9%,37.1%
0500000US18021,18021,18,21,"Clay County, Indiana",26890,307,26583,26366,26146,85,57,60,8,10,217,0.054,0500000US18021,Clay County,26466,460,26006,25196,24880,129,43,91,6,47,810,0.115,0.061,1.115,6.1%,111.5%
0500000US18023,18023,18,23,"Clinton County, Indiana",33224,4395,28829,28624,28349,138,44,65,3,25,205,0.254,0500000US18023,Clinton County,33190,6142,27048,26195,25808,196,62,70,13,46,853,0.360,0.106,0.417,10.6%,41.7%
0500000US18025,18025,18,25,"Crawford County, Indiana",10713,126,10587,10484,10390,21,40,20,9,4,103,0.059,0500000US18025,Crawford County,10526,121,10405,10064,9989,26,23,17,1,8,341,0.098,0.039,0.661,3.9%,66.1%
0500000US18027,18027,18,27,"Daviess County, Indiana",31648,1314,30334,30105,29696,165,62,161,6,15,229,0.118,0500000US18027,Daviess County,33381,2103,31278,30581,29708,619,38,132,8,76,697,0.203,0.085,0.726,8.5%,72.6%
0500000US18029,18029,18,29,"Dearborn County, Indiana",50047,502,49545,49117,48486,291,79,187,24,50,428,0.061,0500000US18029,Dearborn County,50679,724,49955,48059,47319,292,66,211,9,162,1896,0.127,0.065,1.068,6.5%,106.8%
0500000US18031,18031,18,31,"Decatur County, Indiana",25740,426,25314,25118,24796,76,36,178,7,25,196,0.072,0500000US18031,Decatur County,26472,614,25858,25095,24769,90,35,154,8,39,763,0.123,0.051,0.719,5.1%,71.9%
0500000US18033,18033,18,33,"DeKalb County, Indiana",42223,1031,41192,40853,40406,141,84,186,17,19,339,0.084,0500000US18033,DeKalb County,43265,1185,42080,40825,40232,183,67,225,39,79,1255,0.134,0.050,0.600,5.0%,60.0%
0500000US18035,18035,18,35,"Delaware County, Indiana",117671,2088,115583,113400,103721,8051,255,1128,56,189,2183,0.218,0500000US18035,Delaware County,111903,3533,108370,103555,93333,8141,218,1388,58,417,4815,0.296,0.078,0.360,7.8%,36.0%
0500000US18037,18037,18,37,"Dubois County, Indiana",41889,2521,39368,39164,38791,109,51,189,5,19,204,0.139,0500000US18037,Dubois County,43637,4146,39491,38723,38137,190,55,247,5,89,768,0.227,0.088,0.634,8.8%,63.4%
0500000US18039,18039,18,39,"Elkhart County, Indiana",197559,27886,169673,166200,152555,10989,434,1879,60,283,3473,0.380,0500000US18039,Elkhart County,207047,39594,167453,159469,145039,11051,373,2236,54,716,7984,0.468,0.088,0.231,8.8%,23.1%
0500000US18041,18041,18,41,"Fayette County, Indiana",24277,223,24054,23834,23392,318,30,79,0,15,220,0.071,0500000US18041,Fayette County,23398,273,23125,22429,22014,275,32,58,2,48,696,0.114,0.042,0.595,4.2%,59.5%
0500000US18043,18043,18,43,"Floyd County, Indiana",74578,1972,72606,71285,66505,3822,146,694,16,102,1321,0.201,0500000US18043,Floyd County,80484,3082,77402,73655,67970,4276,169,973,21,246,3747,0.280,0.079,0.394,7.9%,39.4%
0500000US18045,18045,18,45,"Fountain County, Indiana",17240,373,16867,16715,16598,26,48,35,1,7,152,0.073,0500000US18045,Fountain County,16479,412,16067,15515,15349,56,38,43,6,23,552,0.131,0.058,0.802,5.8%,80.2%
0500000US18047,18047,18,47,"Franklin County, Indiana",23087,210,22877,22723,22600,34,27,55,2,5,154,0.042,0500000US18047,Franklin County,22785,219,22566,21962,21790,23,25,91,1,32,604,0.085,0.043,1.034,4.3%,103.4%
0500000US18049,18049,18,49,"Fulton County, Indiana",20836,882,19954,19769,19438,144,73,101,5,8,185,0.128,0500000US18049,Fulton County,20480,1068,19412,18776,18452,141,64,76,0,43,636,0.184,0.057,0.444,5.7%,44.4%
0500000US18051,18051,18,51,"Gibson County, Indiana",33503,441,33062,32588,31752,589,59,155,2,31,474,0.101,0500000US18051,Gibson County,33011,680,32331,31202,30159,637,61,214,16,115,1129,0.163,0.062,0.615,6.2%,61.5%
0500000US18053,18053,18,53,"Grant County, Indiana",70061,2517,67544,66166,60633,4805,218,408,14,88,1378,0.245,0500000US18053,Grant County,66674,3412,63262,60009,54500,4566,157,524,22,240,3253,0.322,0.077,0.317,7.7%,31.7%
0500000US18055,18055,18,55,"Greene County, Indiana",33165,322,32843,32593,32343,49,82,96,4,19,250,0.049,0500000US18055,Greene County,30803,551,30252,29315,29035,53,68,104,4,51,937,0.110,0.061,1.259,6.1%,125.9%
0500000US18057,18057,18,57,"Hamilton County, Indiana",274569,9426,265143,260934,237317,9395,437,13122,72,591,4209,0.248,0500000US18057,Hamilton County,347467,18106,329361,315337,275185,14674,402,23459,134,1483,14024,0.362,0.114,0.460,11.4%,46.0%
0500000US18059,18059,18,59,"Hancock County, Indiana",70002,1216,68786,68040,65859,1420,136,554,14,57,746,0.114,0500000US18059,Hancock County,79840,2202,77638,74568,71106,2346,121,734,42,219,3070,0.204,0.090,0.787,9.0%,78.7%
0500000US18061,18061,18,61,"Harrison County, Indiana",39364,581,38783,38426,37984,167,84,153,9,29,357,0.069,0500000US18061,Harrison County,39654,928,38726,37292,36702,185,92,189,17,107,1434,0.141,0.073,1.063,7.3%,106.3%
0500000US18063,18063,18,63,"Hendricks County, Indiana",145448,4379,141069,139107,128664,6988,231,2984,47,193,1962,0.214,0500000US18063,Hendricks County,174788,8056,166732,159450,139374,13350,264,5667,66,729,7282,0.353,0.140,0.654,14.0%,65.4%
0500000US18065,18065,18,65,"Henry County, Indiana",49462,691,48771,48253,46933,1064,63,154,5,34,518,0.099,0500000US18065,Henry County,48914,977,47937,46546,45105,1066,67,197,5,106,1391,0.148,0.049,0.497,4.9%,49.7%
0500000US18067,18067,18,67,"Howard County, Indiana",82752,2203,80549,78808,72091,5585,246,737,13,136,1741,0.235,0500000US18067,Howard County,83658,3060,80598,76447,68470,6416,209,1027,19,306,4151,0.320,0.085,0.361,8.5%,36.1%
0500000US18069,18069,18,69,"Huntington County, Indiana",37124,631,36493,36157,35692,155,124,167,6,13,336,0.075,0500000US18069,Huntington County,36662,1050,35612,34488,33874,221,140,163,7,83,1124,0.144,0.069,0.920,6.9%,92.0%
0500000US18071,18071,18,71,"Jackson County, Indiana",42376,2410,39966,39572,38826,265,82,356,18,25,394,0.157,0500000US18071,Jackson County,46428,6251,40177,38936,37815,485,68,469,5,94,1241,0.318,0.160,1.021,16.0%,102.1%
0500000US18073,18073,18,73,"Jasper County, Indiana",33478,1823,31655,31397,30988,208,53,123,9,16,258,0.140,0500000US18073,Jasper County,32918,2342,30576,29409,29084,129,53,90,10,43,1167,0.213,0.073,0.520,7.3%,52.0%
0500000US18075,18075,18,75,"Jay County, Indiana",21253,577,20676,20525,20356,58,21,77,0,13,151,0.082,0500000US18075,Jay County,20478,944,19534,19071,18892,53,24,64,12,26,463,0.146,0.064,0.787,6.4%,78.7%
0500000US18077,18077,18,77,"Jefferson County, Indiana",32428,755,31673,31297,30463,530,59,211,5,29,376,0.117,0500000US18077,Jefferson County,33147,1111,32036,31018,30023,510,79,290,10,106,1018,0.177,0.061,0.521,6.1%,52.1%
0500000US18079,18079,18,79,"Jennings County, Indiana",28525,571,27954,27671,27361,206,30,62,0,12,283,0.079,0500000US18079,Jennings County,27613,859,26754,25974,25665,175,39,49,2,44,780,0.134,0.055,0.692,5.5%,69.2%
0500000US18081,18081,18,81,"Johnson County, Indiana",139654,4270,135384,133603,128903,1536,252,2716,46,150,1781,0.146,0500000US18081,Johnson County,161765,6394,155371,148990,136748,3850,280,7420,69,623,6381,0.280,0.133,0.909,13.3%,90.9%
0500000US18083,18083,18,83,"Knox County, Indiana",38440,590,37850,37456,36154,994,64,214,11,19,394,0.114,0500000US18083,Knox County,36282,1005,35277,34190,33027,696,67,283,13,104,1087,0.169,0.055,0.480,5.5%,48.0%
0500000US18085,18085,18,85,"Kosciusko County, Indiana",77358,5634,71724,70984,69531,542,178,642,19,72,740,0.187,0500000US18085,Kosciusko County,80240,7492,72748,70389,67990,682,160,1336,16,205,2359,0.272,0.085,0.458,8.5%,45.8%
0500000US18087,18087,18,87,"LaGrange County, Indiana",37128,1317,35811,35591,35290,109,65,118,1,8,220,0.095,0500000US18087,LaGrange County,40446,1733,38713,38084,37834,92,50,74,1,33,629,0.123,0.028,0.290,2.8%,29.0%
0500000US18089,18089,18,89,"Lake County, Indiana",496005,82663,413342,407088,274162,125506,913,5981,63,463,6254,0.602,0500000US18089,Lake County,498700,99927,398773,381956,251106,121048,691,7334,95,1682,16817,0.646,0.044,0.072,4.4%,7.2%
0500000US18091,18091,18,91,"LaPorte County, Indiana",111467,6093,105374,103456,90695,11835,246,570,13,97,1918,0.323,0500000US18091,LaPorte County,112417,7985,104432,99309,85957,11874,250,743,18,467,5123,0.397,0.074,0.228,7.4%,22.8%
0500000US18093,18093,18,93,"Lawrence County, Indiana",46134,545,45589,45141,44562,181,148,224,9,17,448,0.067,0500000US18093,Lawrence County,45011,765,44246,42850,42224,191,131,207,4,93,1396,0.119,0.052,0.779,5.2%,77.9%
0500000US18095,18095,18,95,"Madison County, Indiana",131636,4189,127447,125483,113577,10887,253,547,41,178,1964,0.247,0500000US18095,Madison County,130129,6263,123866,118477,106928,10116,259,649,42,483,5389,0.315,0.067,0.272,6.7%,27.2%
0500000US18097,18097,18,97,"Marion County, Indiana",903393,84466,818927,799085,537905,238454,1954,18119,333,2320,19842,0.566,0500000US18097,Marion County,977203,129286,847917,806650,493665,265659,1752,39827,374,5373,41267,0.650,0.084,0.148,8.4%,14.8%
0500000US18099,18099,18,99,"Marshall County, Indiana",47051,3971,43080,42602,42098,196,80,210,2,16,478,0.192,0500000US18099,Marshall County,46095,5251,40844,39570,38910,204,63,274,7,112,1274,0.274,0.081,0.424,8.1%,42.4%
0500000US18101,18101,18,101,"Martin County, Indiana",10334,70,10264,10194,10125,10,26,29,0,4,70,0.040,0500000US18101,Martin County,9812,92,9720,9425,9335,20,20,33,6,11,295,0.094,0.054,1.350,5.4%,135.0%
0500000US18103,18103,18,103,"Miami County, Indiana",36903,906,35997,35425,33307,1649,309,128,8,24,572,0.182,0500000US18103,Miami County,35962,1186,34776,33432,31123,1792,281,130,4,102,1344,0.246,0.063,0.348,6.3%,34.8%
0500000US18105,18105,18,105,"Monroe County, Indiana",137974,4029,133945,130966,118837,4363,288,7190,56,232,2979,0.253,0500000US18105,Monroe County,139718,6358,133360,126653,112490,5016,222,8350,37,538,6707,0.343,0.089,0.353,8.9%,35.3%
0500000US18107,18107,18,107,"Montgomery County, Indiana",38124,1739,36385,35997,35374,307,72,209,6,29,388,0.137,0500000US18107,Montgomery County,37936,2281,35655,34490,33748,343,73,236,13,77,1165,0.204,0.067,0.491,6.7%,49.1%
0500000US18109,18109,18,109,"Morgan County, Indiana",68894,820,68074,67424,66782,175,177,241,19,30,650,0.060,0500000US18109,Morgan County,71780,1274,70506,67971,66972,339,195,276,11,178,2535,0.128,0.068,1.127,6.8%,112.7%
0500000US18111,18111,18,111,"Newton County, Indiana",14244,717,13527,13430,13296,53,33,38,2,8,97,0.126,0500000US18111,Newton County,13830,1039,12791,12190,12053,42,25,34,2,34,601,0.233,0.107,0.847,10.7%,84.7%
0500000US18113,18113,18,113,"Noble County, Indiana",47536,4567,42969,42570,42104,170,90,174,5,27,399,0.206,0500000US18113,Noble County,47457,5250,42207,40851,40235,217,71,223,1,104,1356,0.268,0.062,0.300,6.2%,30.0%
0500000US18115,18115,18,115,"Ohio County, Indiana",6128,69,6059,6021,5967,21,11,19,0,3,38,0.052,0500000US18115,Ohio County,5940,79,5861,5694,5629,16,4,29,0,16,167,0.101,0.049,0.954,4.9%,95.4%
0500000US18117,18117,18,117,"Orange County, Indiana",19840,194,19646,19434,19144,168,52,61,2,7,212,0.069,0500000US18117,Orange County,19867,305,19562,18869,18527,200,37,60,11,34,693,0.129,0.060,0.876,6.0%,87.6%
0500000US18119,18119,18,119,"Owen County, Indiana",21575,198,21377,21200,20983,65,72,65,1,14,177,0.054,0500000US18119,Owen County,21321,297,21024,20112,19874,79,47,62,0,50,912,0.129,0.075,1.393,7.5%,139.3%
0500000US18121,18121,18,121,"Parke County, Indiana",17339,215,17124,17032,16545,391,53,33,4,6,92,0.089,0500000US18121,Parke County,16156,225,15931,15624,15329,198,55,30,0,12,307,0.099,0.010,0.115,1.0%,11.5%
0500000US18123,18123,18,123,"Perry County, Indiana",19338,192,19146,19015,18428,469,34,69,4,11,131,0.091,0500000US18123,Perry County,19170,220,18950,18431,17853,397,33,99,3,46,519,0.131,0.040,0.441,4.0%,44.1%
0500000US18125,18125,18,125,"Pike County, Indiana",12845,120,12725,12643,12544,38,25,25,3,8,82,0.046,0500000US18125,Pike County,12250,180,12070,11762,11666,31,39,15,0,11,308,0.092,0.046,0.997,4.6%,99.7%
0500000US18127,18127,18,127,"Porter County, Indiana",164343,13933,150410,148402,141243,4649,349,1960,31,170,2008,0.253,0500000US18127,Porter County,173215,18904,154311,147348,136993,7246,259,2197,51,602,6963,0.359,0.106,0.419,10.6%,41.9%
0500000US18129,18129,18,129,"Posey County, Indiana",25910,248,25662,25409,25046,230,42,70,4,17,253,0.065,0500000US18129,Posey County,25222,375,24847,24062,23640,211,44,107,3,57,785,0.120,0.055,0.841,5.5%,84.1%
0500000US18131,18131,18,131,"Pulaski County, Indiana",13402,325,13077,12978,12823,87,38,27,3,0,99,0.084,0500000US18131,Pulaski County,12514,458,12056,11592,11442,65,24,44,3,14,464,0.161,0.077,0.923,7.7%,92.3%
0500000US18133,18133,18,133,"Putnam County, Indiana",37963,587,37376,37020,35128,1485,90,273,10,34,356,0.142,0500000US18133,Putnam County,36726,784,35942,34739,33150,1024,70,355,14,126,1203,0.183,0.041,0.289,4.1%,28.9%
0500000US18135,18135,18,135,"Randolph County, Indiana",26171,790,25381,25166,24895,114,83,57,8,9,215,0.094,0500000US18135,Randolph County,24502,1156,23346,22623,22325,119,52,67,0,60,723,0.167,0.073,0.771,7.3%,77.1%
0500000US18137,18137,18,137,"Ripley County, Indiana",28818,445,28373,28151,27879,67,37,146,3,19,222,0.064,0500000US18137,Ripley County,28995,541,28454,27567,27213,73,45,183,0,53,887,0.118,0.054,0.847,5.4%,84.7%
0500000US18139,18139,18,139,"Rush County, Indiana",17392,190,17202,17080,16839,129,32,57,3,20,122,0.062,0500000US18139,Rush County,16752,252,16500,16078,15876,90,19,54,3,36,422,0.101,0.039,0.619,3.9%,61.9%
0500000US18141,18141,18,141,"St. Joseph County, Indiana",266931,19395,247536,241481,201701,33407,791,4985,180,417,6055,0.407,0500000US18141,St. Joseph County,272912,26576,246336,232844,188556,35420,773,6586,159,1350,13492,0.493,0.086,0.211,8.6%,21.1%
0500000US18143,18143,18,143,"Scott County, Indiana",24181,354,23827,23692,23471,52,43,104,14,8,135,0.058,0500000US18143,Scott County,24384,535,23849,23090,22829,92,27,87,11,44,759,0.122,0.064,1.118,6.4%,111.8%
0500000US18145,18145,18,145,"Shelby County, Indiana",44436,1647,42789,42404,41622,428,85,242,7,20,385,0.121,0500000US18145,Shelby County,45055,2377,42678,41371,40305,537,60,339,3,127,1307,0.196,0.075,0.618,7.5%,61.8%
0500000US18147,18147,18,147,"Spencer County, Indiana",20952,517,20435,20314,20101,96,38,69,0,10,121,0.079,0500000US18147,Spencer County,19810,676,19134,18643,18368,129,44,73,1,28,491,0.138,0.060,0.755,6.0%,75.5%
0500000US18149,18149,18,149,"Starke County, Indiana",23363,766,22597,22379,22212,63,61,41,0,2,218,0.095,0500000US18149,Starke County,23371,902,22469,21607,21395,67,60,40,4,41,862,0.159,0.064,0.676,6.4%,67.6%
0500000US18151,18151,18,151,"Steuben County, Indiana",34185,982,33203,32929,32513,155,81,162,6,12,274,0.094,0500000US18151,Steuben County,34435,1427,33008,32019,31438,234,64,187,2,94,989,0.164,0.069,0.734,6.9%,73.4%
0500000US18153,18153,18,153,"Sullivan County, Indiana",21475,294,21181,20980,19930,946,53,39,1,11,201,0.136,0500000US18153,Sullivan County,20817,334,20483,19845,18856,877,43,33,8,28,638,0.177,0.040,0.294,4.0%,29.4%
0500000US18155,18155,18,155,"Switzerland County, Indiana",10613,147,10466,10397,10318,31,16,18,2,12,69,0.055,0500000US18155,Switzerland County,9737,114,9623,9333,9262,14,26,20,0,11,290,0.094,0.040,0.725,4.0%,72.5%
0500000US18157,18157,18,157,"Tippecanoe County, Indiana",172780,12947,159833,156892,138855,6731,349,10679,41,237,2941,0.343,0500000US18157,Tippecanoe County,186251,18647,167604,157333,131465,11080,346,13613,38,791,10271,0.480,0.137,0.399,13.7%,39.9%
0500000US18159,18159,18,159,"Tipton County, Indiana",15936,346,15590,15476,15355,28,20,64,5,4,114,0.071,0500000US18159,Tipton County,15359,434,14925,14530,14367,46,13,46,2,56,395,0.124,0.052,0.739,5.2%,73.9%
0500000US18161,18161,18,161,"Union County, Indiana",7516,82,7434,7361,7280,33,19,19,6,4,73,0.062,0500000US18161,Union County,7087,74,7013,6861,6765,21,22,33,8,12,152,0.088,0.027,0.432,2.7%,43.2%
0500000US18163,18163,18,163,"Vanderburgh County, Indiana",179703,3873,175830,172116,153080,16228,345,1986,89,388,3714,0.265,0500000US18163,Vanderburgh County,180136,6313,173823,165031,143444,17459,331,2411,677,709,8792,0.353,0.088,0.330,8.8%,33.0%
0500000US18165,18165,18,165,"Vermillion County, Indiana",16212,130,16082,15956,15862,21,29,31,5,8,126,0.043,0500000US18165,Vermillion County,15439,168,15271,14831,14692,37,27,46,11,18,440,0.093,0.051,1.195,5.1%,119.5%
0500000US18167,18167,18,167,"Vigo County, Indiana",107848,2469,105379,103199,93550,7371,321,1777,32,148,2180,0.242,0500000US18167,Vigo County,106153,3239,102914,98171,88137,7079,311,2003,25,616,4743,0.303,0.061,0.253,6.1%,25.3%
0500000US18169,18169,18,169,"Wabash County, Indiana",32888,697,32191,31884,31369,155,211,134,6,9,307,0.090,0500000US18169,Wabash County,30976,897,30079,29154,28634,158,126,161,9,66,925,0.144,0.054,0.603,5.4%,60.3%
0500000US18171,18171,18,171,"Warren County, Indiana",8508,70,8438,8389,8321,10,13,36,6,3,49,0.043,0500000US18171,Warren County,8440,193,8247,8069,8018,7,7,26,0,11,178,0.097,0.053,1.226,5.3%,122.6%
0500000US18173,18173,18,173,"Warrick County, Indiana",59689,946,58743,58005,56095,780,98,957,18,57,738,0.116,0500000US18173,Warrick County,63898,1383,62515,60309,57346,1038,92,1639,11,183,2206,0.192,0.076,0.655,7.6%,65.5%
0500000US18175,18175,18,175,"Washington County, Indiana",28262,304,27958,27760,27539,63,45,86,2,25,198,0.050,0500000US18175,Washington County,28182,400,27782,26951,26600,113,66,95,10,67,831,0.108,0.058,1.146,5.8%,114.6%
0500000US18177,18177,18,177,"Wayne County, Indiana",68917,1804,67113,65479,61322,3349,140,522,44,102,1634,0.205,0500000US18177,Wayne County,66553,2495,64058,60907,56689,3027,142,707,12,330,3151,0.269,0.064,0.313,6.4%,31.3%
0500000US18179,18179,18,179,"Wells County, Indiana",27636,564,27072,26873,26604,89,71,102,3,4,199,0.073,0500000US18179,Wells County,28180,1019,27161,26445,26000,220,50,130,5,40,716,0.147,0.074,1.015,7.4%,101.5%
0500000US18181,18181,18,181,"White County, Indiana",24643,1746,22897,22670,22470,51,52,83,4,10,227,0.163,0500000US18181,White County,24688,2453,22235,21493,21203,111,50,94,6,29,742,0.252,0.088,0.539,8.8%,53.9%
0500000US18183,18183,18,183,"Whitley County, Indiana",33292,515,32777,32453,32147,96,76,105,7,22,324,0.067,0500000US18183,Whitley County,34191,841,33350,32327,31832,150,91,173,3,78,1023,0.132,0.064,0.958,6.4%,95.8%
0500000US19001,19001,19,1,"Adair County, Iowa",7682,101,7581,7547,7507,11,4,22,1,2,34,0.045,0500000US19001,Adair County,7496,186,7310,7155,7066,45,16,23,1,4,155,0.110,0.066,1.461,6.6%,146.1%
0500000US19003,19003,19,3,"Adams County, Iowa",4029,37,3992,3971,3922,8,18,23,0,0,21,0.052,0500000US19003,Adams County,3704,42,3662,3573,3518,12,15,13,0,15,89,0.097,0.045,0.860,4.5%,86.0%
0500000US19005,19005,19,5,"Allamakee County, Iowa",14330,757,13573,13512,13325,109,31,33,11,3,61,0.132,0500000US19005,Allamakee County,14061,1221,12840,12631,12401,146,14,41,5,24,209,0.214,0.082,0.618,8.2%,61.8%
0500000US19007,19007,19,7,"Appanoose County, Iowa",12887,181,12706,12592,12470,55,30,35,0,2,114,0.063,0500000US19007,Appanoose County,12317,231,12086,11763,11586,75,19,69,0,14,323,0.114,0.051,0.800,5.1%,80.0%
0500000US19009,19009,19,9,"Audubon County, Iowa",6119,37,6082,6050,6007,9,7,25,1,1,32,0.036,0500000US19009,Audubon County,5674,86,5588,5474,5443,17,5,4,1,4,114,0.079,0.043,1.186,4.3%,118.6%
0500000US19011,19011,19,11,"Benton County, Iowa",26076,275,25801,25594,25387,93,41,66,2,5,207,0.052,0500000US19011,Benton County,25575,462,25113,24356,24077,112,29,79,2,57,757,0.112,0.061,1.165,6.1%,116.5%
0500000US19013,19013,19,13,"Black Hawk County, Iowa",131090,4907,126183,123654,109968,11493,209,1685,175,124,2529,0.287,0500000US19013,Black Hawk County,131144,6448,124696,119535,101150,13529,219,3412,848,377,5161,0.390,0.103,0.360,10.3%,36.0%
0500000US19015,19015,19,15,"Boone County, Iowa",26306,505,25801,25575,25194,202,72,87,3,17,226,0.082,0500000US19015,Boone County,26715,709,26006,25205,24720,289,51,100,3,42,801,0.142,0.060,0.727,6.0%,72.7%
0500000US19017,19017,19,17,"Bremer County, Iowa",24276,239,24037,23835,23459,186,11,173,2,4,202,0.066,0500000US19017,Bremer County,24988,511,24477,23898,23403,239,26,196,2,32,579,0.122,0.056,0.847,5.6%,84.7%
0500000US19019,19019,19,19,"Buchanan County, Iowa",20958,243,20715,20520,20344,59,22,90,1,4,195,0.057,0500000US19019,Buchanan County,20565,338,20227,19733,19565,70,18,52,11,17,494,0.094,0.037,0.636,3.7%,63.6%
0500000US19021,19021,19,21,"Buena Vista County, Iowa",20260,4608,15652,15495,13756,497,18,1119,95,10,157,0.484,0500000US19021,Buena Vista County,20823,5925,14898,14546,11377,560,29,1889,614,77,352,0.610,0.127,0.262,12.7%,26.2%
0500000US19023,19023,19,23,"Butler County, Iowa",14867,133,14734,14628,14552,25,14,35,2,0,106,0.042,0500000US19023,Butler County,14334,183,14151,13840,13751,26,16,28,0,19,311,0.079,0.037,0.892,3.7%,89.2%
0500000US19025,19025,19,25,"Calhoun County, Iowa",9670,90,9580,9530,9470,19,18,20,1,2,50,0.041,0500000US19025,Calhoun County,9927,236,9691,9485,9261,151,22,24,8,19,206,0.128,0.088,2.147,8.8%,214.7%
0500000US19027,19027,19,27,"Carroll County, Iowa",20816,333,20483,20318,20119,82,20,92,0,5,165,0.065,0500000US19027,Carroll County,20760,594,20166,19783,19409,262,19,75,0,18,383,0.125,0.059,0.902,5.9%,90.2%
0500000US19029,19029,19,29,"Cass County, Iowa",13956,253,13703,13642,13502,33,23,30,45,9,61,0.064,0500000US19029,Cass County,13127,306,12821,12503,12317,28,17,35,78,28,318,0.118,0.055,0.861,5.5%,86.1%
0500000US19031,19031,19,31,"Cedar County, Iowa",18499,284,18215,18053,17897,52,23,78,2,1,162,0.064,0500000US19031,Cedar County,18505,462,18043,17570,17334,79,40,61,2,54,473,0.121,0.058,0.904,5.8%,90.4%
0500000US19033,19033,19,33,"Cerro Gordo County, Iowa",44151,1694,42457,41893,40876,555,68,368,8,18,564,0.141,0500000US19033,Cerro Gordo County,43127,2243,40884,39517,37819,848,96,535,137,82,1367,0.227,0.086,0.608,8.6%,60.8%
0500000US19035,19035,19,35,"Cherokee County, Iowa",12072,274,11798,11709,11553,64,29,62,1,0,89,0.084,0500000US19035,Cherokee County,11658,530,11128,10875,10668,84,24,57,14,28,253,0.160,0.076,0.916,7.6%,91.6%
0500000US19037,19037,19,37,"Chickasaw County, Iowa",12439,269,12170,12122,12048,29,5,40,0,0,48,0.061,0500000US19037,Chickasaw County,12012,481,11531,11290,11173,75,7,28,0,7,241,0.133,0.071,1.163,7.1%,116.3%
0500000US19039,19039,19,39,"Clarke County, Iowa",9286,927,8359,8298,8208,38,15,32,4,1,61,0.209,0500000US19039,Clarke County,9748,1534,8214,8036,7837,43,7,81,40,28,178,0.328,0.120,0.574,12.0%,57.4%
0500000US19041,19041,19,41,"Clay County, Iowa",16667,477,16190,16046,15843,68,36,98,0,1,144,0.095,0500000US19041,Clay County,16384,704,15680,15280,15025,99,37,105,2,12,400,0.156,0.061,0.639,6.1%,63.9%
0500000US19043,19043,19,43,"Clayton County, Iowa",18129,306,17823,17697,17563,60,13,42,17,2,126,0.061,0500000US19043,Clayton County,17043,343,16700,16372,16111,158,34,47,6,16,328,0.106,0.044,0.726,4.4%,72.6%
0500000US19045,19045,19,45,"Clinton County, Iowa",49116,1243,47873,47122,45454,1258,101,277,9,23,751,0.142,0500000US19045,Clinton County,46460,1539,44921,43087,41226,1392,103,252,10,104,1834,0.209,0.067,0.472,6.7%,47.2%
0500000US19047,19047,19,47,"Crawford County, Iowa",17096,4131,12965,12880,12541,195,26,97,8,13,85,0.403,0500000US19047,Crawford County,16525,4912,11613,11373,10625,383,31,303,4,27,240,0.497,0.094,0.233,9.4%,23.3%
0500000US19049,19049,19,49,"Dallas County, Iowa",66135,4059,62076,61350,58630,890,94,1652,37,47,726,0.209,0500000US19049,Dallas County,99678,6515,93163,89861,81708,2657,137,4987,32,340,3302,0.319,0.110,0.526,11.0%,52.6%
0500000US19051,19051,19,51,"Davis County, Iowa",8753,85,8668,8604,8556,7,17,24,0,0,64,0.044,0500000US19051,Davis County,9110,144,8966,8779,8735,8,11,15,0,10,187,0.080,0.036,0.803,3.6%,80.3%
0500000US19053,19053,19,53,"Decatur County, Iowa",8457,181,8276,8201,7946,149,28,53,16,9,75,0.116,0500000US19053,Decatur County,7645,211,7434,7210,7010,97,17,39,21,26,224,0.157,0.041,0.353,4.1%,35.3%
0500000US19055,19055,19,55,"Delaware County, Iowa",17764,139,17625,17522,17408,45,17,44,0,8,103,0.040,0500000US19055,Delaware County,17488,244,17244,16921,16706,122,24,39,0,30,323,0.087,0.047,1.195,4.7%,119.5%
0500000US19057,19057,19,57,"Des Moines County, Iowa",40325,1042,39283,38480,36059,2005,88,285,18,25,803,0.197,0500000US19057,Des Moines County,38910,1245,37665,35868,32753,2501,67,398,21,128,1797,0.284,0.087,0.443,8.7%,44.3%
0500000US19059,19059,19,59,"Dickinson County, Iowa",16667,178,16489,16378,16255,29,12,72,5,5,111,0.049,0500000US19059,Dickinson County,17703,406,17297,16905,16709,76,14,80,1,25,392,0.108,0.059,1.222,5.9%,122.2%
0500000US19061,19061,19,61,"Dubuque County, Iowa",93653,1807,91846,90763,86981,2436,144,871,282,49,1083,0.136,0500000US19061,Dubuque County,99266,2977,96289,93601,87349,4035,131,1018,813,255,2688,0.222,0.086,0.632,8.6%,63.2%
0500000US19063,19063,19,63,"Emmet County, Iowa",10302,763,9539,9464,9319,61,35,44,1,4,75,0.176,0500000US19063,Emmet County,9388,887,8501,8300,8134,89,31,32,3,11,201,0.240,0.064,0.362,6.4%,36.2%
0500000US19065,19065,19,65,"Fayette County, Iowa",20880,380,20500,20330,19987,196,21,105,15,6,170,0.083,0500000US19065,Fayette County,19509,520,18989,18403,18053,200,40,78,1,31,586,0.142,0.059,0.706,5.9%,70.6%
0500000US19067,19067,19,67,"Floyd County, Iowa",16303,331,15972,15875,15443,200,13,213,4,2,97,0.102,0500000US19067,Floyd County,15627,550,15077,14670,13907,415,29,293,12,14,407,0.205,0.103,1.011,10.3%,101.1%
0500000US19069,19069,19,69,"Franklin County, Iowa",10680,1209,9471,9398,9334,19,12,28,1,4,73,0.223,0500000US19069,Franklin County,10019,1634,8385,8159,8034,32,18,49,0,26,226,0.330,0.107,0.477,10.7%,47.7%
0500000US19071,19071,19,71,"Fremont County, Iowa",7441,187,7254,7199,7123,32,22,18,1,3,55,0.083,0500000US19071,Fremont County,6605,190,6415,6207,6145,10,19,8,5,20,208,0.133,0.050,0.599,5.0%,59.9%
0500000US19073,19073,19,73,"Greene County, Iowa",9336,171,9165,9105,9017,22,25,30,3,8,60,0.067,0500000US19073,Greene County,8771,256,8515,8286,8188,22,15,48,1,12,229,0.127,0.060,0.901,6.0%,90.1%
0500000US19075,19075,19,75,"Grundy County, Iowa",12453,122,12331,12255,12190,26,4,27,7,1,76,0.042,0500000US19075,Grundy County,12329,145,12184,11883,11791,43,10,24,0,15,301,0.085,0.043,1.032,4.3%,103.2%
0500000US19077,19077,19,77,"Guthrie County, Iowa",10954,202,10752,10673,10595,16,21,37,4,0,79,0.064,0500000US19077,Guthrie County,10623,274,10349,10112,9960,27,21,37,16,51,237,0.120,0.056,0.869,5.6%,86.9%
0500000US19079,19079,19,79,"Hamilton County, Iowa",15673,782,14891,14729,14344,40,26,311,0,8,162,0.159,0500000US19079,Hamilton County,15039,1465,13574,13156,12702,88,25,314,0,27,418,0.276,0.117,0.731,11.7%,73.1%
0500000US19081,19081,19,81,"Hancock County, Iowa",11341,398,10943,10859,10744,50,10,47,1,7,84,0.101,0500000US19081,Hancock County,10795,614,10181,9939,9813,76,22,25,0,3,242,0.170,0.069,0.679,6.9%,67.9%
0500000US19083,19083,19,83,"Hardin County, Iowa",17534,651,16883,16741,16430,208,31,68,1,3,142,0.120,0500000US19083,Hardin County,16878,818,16060,15581,15292,144,25,86,2,32,479,0.176,0.055,0.461,5.5%,46.1%
0500000US19085,19085,19,85,"Harrison County, Iowa",14928,183,14745,14637,14532,25,39,41,0,0,108,0.052,0500000US19085,Harrison County,14582,293,14289,13943,13818,27,25,49,0,24,346,0.101,0.049,0.938,4.9%,93.8%
0500000US19087,19087,19,87,"Henry County, Iowa",20145,764,19381,19100,18141,435,46,450,20,8,281,0.186,0500000US19087,Henry County,20482,1083,19399,18736,17643,501,60,451,8,73,663,0.253,0.067,0.357,6.7%,35.7%
0500000US19089,19089,19,89,"Howard County, Iowa",9566,118,9448,9380,9314,25,9,24,7,1,68,0.052,0500000US19089,Howard County,9469,258,9211,8994,8890,23,33,27,7,14,217,0.117,0.065,1.265,6.5%,126.5%
0500000US19091,19091,19,91,"Humboldt County, Iowa",9815,357,9458,9376,9288,39,14,31,0,4,82,0.103,0500000US19091,Humboldt County,9597,430,9167,8941,8823,53,16,21,6,22,226,0.152,0.049,0.476,4.9%,47.6%
0500000US19093,19093,19,93,"Ida County, Iowa",7089,100,6989,6954,6907,17,9,19,1,1,35,0.050,0500000US19093,Ida County,7005,255,6750,6627,6554,28,0,18,11,16,123,0.123,0.073,1.437,7.3%,143.7%
0500000US19095,19095,19,95,"Iowa County, Iowa",16355,307,16048,15950,15818,53,14,54,2,9,98,0.064,0500000US19095,Iowa County,16662,495,16167,15676,15394,111,29,84,1,57,491,0.145,0.080,1.253,8.0%,125.3%
0500000US19097,19097,19,97,"Jackson County, Iowa",19848,220,19628,19455,19223,58,37,47,88,2,173,0.062,0500000US19097,Jackson County,19485,237,19248,18829,18369,140,33,46,190,51,419,0.110,0.049,0.789,4.9%,78.9%
0500000US19099,19099,19,99,"Jasper County, Iowa",36842,537,36305,36022,35284,464,101,163,8,2,283,0.082,0500000US19099,Jasper County,37813,1087,36726,35568,34445,683,91,215,30,104,1158,0.168,0.086,1.041,8.6%,104.1%
0500000US19101,19101,19,101,"Jefferson County, Iowa",16843,410,16433,16209,14539,199,28,1420,2,21,224,0.247,0500000US19101,Jefferson County,15663,610,15053,14470,13425,409,43,500,9,84,583,0.261,0.014,0.056,1.4%,5.6%
0500000US19103,19103,19,103,"Johnson County, Iowa",130882,6200,124682,122207,108767,6163,226,6774,47,230,2475,0.302,0500000US19103,Johnson County,152854,10198,142656,136457,114491,12643,193,8555,41,534,6199,0.423,0.121,0.401,12.1%,40.1%
0500000US19105,19105,19,105,"Jones County, Iowa",20638,270,20368,20261,19716,405,42,90,2,6,107,0.087,0500000US19105,Jones County,20646,497,20149,19615,19002,437,53,58,2,63,534,0.151,0.064,0.743,6.4%,74.3%
0500000US19107,19107,19,107,"Keokuk County, Iowa",10511,90,10421,10367,10286,50,14,16,0,1,54,0.042,0500000US19107,Keokuk County,10033,215,9818,9550,9476,47,4,16,0,7,268,0.107,0.065,1.528,6.5%,152.8%
0500000US19109,19109,19,109,"Kossuth County, Iowa",15543,215,15328,15237,15121,43,8,59,0,6,91,0.053,0500000US19109,Kossuth County,14828,603,14225,13927,13758,71,9,71,3,15,298,0.137,0.084,1.570,8.4%,157.0%
0500000US19111,19111,19,111,"Lee County, Iowa",35862,1092,34770,34187,32833,1094,61,181,7,11,583,0.160,0500000US19111,Lee County,33555,1110,32445,31048,29888,896,48,139,8,69,1397,0.203,0.043,0.272,4.3%,27.2%
0500000US19113,19113,19,113,"Linn County, Iowa",211226,5534,205692,201333,188592,8160,479,3783,162,157,4359,0.200,0500000US19113,Linn County,230299,8911,221388,211019,187911,16200,382,5345,522,659,10369,0.325,0.125,0.627,12.5%,62.7%
0500000US19115,19115,19,115,"Louisa County, Iowa",11387,1797,9590,9502,9309,52,26,101,7,7,88,0.307,0500000US19115,Louisa County,10837,1728,9109,8848,8485,73,11,265,0,14,261,0.360,0.054,0.175,5.4%,17.5%
0500000US19117,19117,19,117,"Lucas County, Iowa",8898,89,8809,8763,8720,15,9,15,3,1,46,0.039,0500000US19117,Lucas County,8634,198,8436,8213,8154,18,6,29,0,6,223,0.107,0.067,1.708,6.7%,170.8%
0500000US19119,19119,19,119,"Lyon County, Iowa",11581,212,11369,11312,11267,9,8,25,0,3,57,0.053,0500000US19119,Lyon County,11934,407,11527,11305,11175,38,20,24,43,5,222,0.122,0.068,1.289,6.8%,128.9%
0500000US19121,19121,19,121,"Madison County, Iowa",15679,197,15482,15361,15233,45,26,51,1,5,121,0.056,0500000US19121,Madison County,16548,316,16232,15712,15504,44,15,83,9,57,520,0.121,0.065,1.163,6.5%,116.3%
0500000US19123,19123,19,123,"Mahaska County, Iowa",22381,360,22021,21802,21242,251,47,250,4,8,219,0.099,0500000US19123,Mahaska County,22190,480,21710,20983,20259,384,41,250,15,34,727,0.164,0.066,0.669,6.6%,66.9%
0500000US19125,19125,19,125,"Marion County, Iowa",33309,531,32778,32479,31834,211,44,379,6,5,299,0.086,0500000US19125,Marion County,33414,700,32714,31771,30918,281,64,401,21,86,943,0.142,0.056,0.653,5.6%,65.3%
0500000US19127,19127,19,127,"Marshall County, Iowa",40648,7017,33631,33138,31807,629,104,526,39,33,493,0.357,0500000US19127,Marshall County,40105,9140,30965,29982,27438,785,153,1514,33,59,983,0.478,0.120,0.336,12.0%,33.6%
0500000US19129,19129,19,129,"Mills County, Iowa",15059,359,14700,14559,14390,57,41,55,10,6,141,0.086,0500000US19129,Mills County,14484,461,14023,13517,13330,77,21,48,10,31,506,0.151,0.065,0.749,6.5%,74.9%
0500000US19131,19131,19,131,"Mitchell County, Iowa",10776,110,10666,10623,10564,20,9,28,2,0,43,0.039,0500000US19131,Mitchell County,10565,193,10372,10197,10080,42,3,45,4,23,175,0.089,0.050,1.294,5.0%,129.4%
0500000US19133,19133,19,133,"Monona County, Iowa",9243,107,9136,9051,8904,33,90,20,4,0,85,0.072,0500000US19133,Monona County,8751,236,8515,8279,8051,28,146,27,2,25,236,0.152,0.080,1.118,8.0%,111.8%
0500000US19135,19135,19,135,"Monroe County, Iowa",7970,169,7801,7739,7677,22,10,29,0,1,62,0.072,0500000US19135,Monroe County,7577,117,7460,7271,7192,18,12,16,2,31,189,0.098,0.027,0.370,2.7%,37.0%
0500000US19137,19137,19,137,"Montgomery County, Iowa",10740,305,10435,10354,10265,25,35,23,5,1,81,0.086,0500000US19137,Montgomery County,10330,371,9959,9676,9603,25,18,21,2,7,283,0.134,0.048,0.562,4.8%,56.2%
0500000US19139,19139,19,139,"Muscatine County, Iowa",42745,6803,35942,35527,34518,545,76,334,13,41,415,0.322,0500000US19139,Muscatine County,43235,7769,35466,34285,32633,1086,58,404,0,104,1181,0.397,0.074,0.231,7.4%,23.1%
0500000US19141,19141,19,141,"O'Brien County, Iowa",14398,545,13853,13766,13605,56,16,82,1,6,87,0.106,0500000US19141,O'Brien County,14182,985,13197,12923,12609,159,39,79,11,26,274,0.204,0.099,0.933,9.9%,93.3%
0500000US19143,19143,19,143,"Osceola County, Iowa",6462,430,6032,5994,5937,15,19,19,1,3,38,0.151,0500000US19143,Osceola County,6192,603,5589,5455,5341,28,18,21,36,11,134,0.246,0.095,0.624,9.5%,62.4%
0500000US19145,19145,19,145,"Page County, Iowa",15932,438,15494,15305,14767,344,69,116,4,5,189,0.139,0500000US19145,Page County,15211,464,14747,14243,13686,365,60,117,0,15,504,0.188,0.048,0.346,4.8%,34.6%
0500000US19147,19147,19,147,"Palo Alto County, Iowa",9421,152,9269,9209,9108,44,21,31,4,1,60,0.065,0500000US19147,Palo Alto County,8996,274,8722,8522,8391,52,15,37,6,21,200,0.129,0.063,0.977,6.3%,97.7%
0500000US19149,19149,19,149,"Plymouth County, Iowa",24986,742,24244,24042,23782,73,51,115,16,5,202,0.093,0500000US19149,Plymouth County,25698,1496,24202,23625,22941,354,48,111,117,54,577,0.199,0.106,1.137,10.6%,113.7%
0500000US19151,19151,19,151,"Pocahontas County, Iowa",7310,166,7144,7098,7043,26,9,12,8,0,46,0.071,0500000US19151,Pocahontas County,7078,354,6724,6535,6383,66,10,29,23,24,189,0.183,0.112,1.578,11.2%,157.8%
0500000US19153,19153,19,153,"Polk County, Iowa",430640,32647,397993,389899,347710,25344,894,15118,228,605,8094,0.337,0500000US19153,Polk County,492401,48055,444346,424637,362260,34990,1081,24313,280,1713,19709,0.440,0.103,0.305,10.3%,30.5%
0500000US19155,19155,19,155,"Pottawattamie County, Iowa",93158,6151,87007,85769,83609,1216,334,549,25,36,1238,0.190,0500000US19155,Pottawattamie County,93667,7660,86007,82535,79181,1836,391,773,76,278,3472,0.277,0.087,0.459,8.7%,45.9%
0500000US19157,19157,19,157,"Poweshiek County, Iowa",18914,456,18458,18241,17705,213,41,255,21,6,217,0.123,0500000US19157,Poweshiek County,18662,529,18133,17648,17004,320,53,221,21,29,485,0.168,0.045,0.368,4.5%,36.8%
0500000US19159,19159,19,159,"Ringgold County, Iowa",5131,91,5040,5014,4966,17,13,16,0,2,26,0.063,0500000US19159,Ringgold County,4663,71,4592,4467,4447,2,7,8,0,3,125,0.090,0.027,0.423,2.7%,42.3%
0500000US19161,19161,19,161,"Sac County, Iowa",10350,195,10155,10087,10031,31,6,15,3,1,68,0.060,0500000US19161,Sac County,9814,354,9460,9278,9161,46,11,31,6,23,182,0.127,0.067,1.106,6.7%,110.6%
0500000US19163,19163,19,163,"Scott County, Iowa",165224,9197,156027,152181,136884,11413,369,3295,53,167,3846,0.305,0500000US19163,Scott County,174669,12092,162577,154007,134578,13701,324,4824,57,523,8570,0.392,0.087,0.287,8.7%,28.7%
0500000US19165,19165,19,165,"Shelby County, Iowa",12167,219,11948,11871,11763,31,24,46,0,7,77,0.065,0500000US19165,Shelby County,11746,412,11334,11033,10890,53,29,49,3,9,301,0.139,0.074,1.134,7.4%,113.4%
0500000US19167,19167,19,167,"Sioux County, Iowa",33704,3001,30703,30513,30090,104,48,264,3,4,190,0.195,0500000US19167,Sioux County,35872,4914,30958,30456,29919,184,87,219,5,42,502,0.285,0.090,0.464,9.0%,46.4%
0500000US19169,19169,19,169,"Story County, Iowa",89542,2695,86847,85569,77812,2125,134,5369,17,112,1278,0.240,0500000US19169,Story County,98537,5032,93505,88958,79944,2980,226,5444,29,335,4547,0.333,0.093,0.390,9.3%,39.0%
0500000US19171,19171,19,171,"Tama County, Iowa",17767,1320,16447,16172,14874,59,1183,45,3,8,275,0.289,0500000US19171,Tama County,17135,1804,15331,14777,13284,125,1258,80,2,28,554,0.381,0.092,0.320,9.2%,32.0%
0500000US19173,19173,19,173,"Taylor County, Iowa",6317,364,5953,5910,5872,12,9,17,0,0,43,0.133,0500000US19173,Taylor County,5896,399,5497,5355,5304,1,13,15,1,21,142,0.186,0.053,0.400,5.3%,40.0%
0500000US19175,19175,19,175,"Union County, Iowa",12534,225,12309,12211,12029,88,30,59,3,2,98,0.078,0500000US19175,Union County,12138,399,11739,11444,11223,114,25,65,7,10,295,0.143,0.065,0.825,6.5%,82.5%
0500000US19177,19177,19,177,"Van Buren County, Iowa",7570,88,7482,7440,7373,15,10,40,1,1,42,0.051,0500000US19177,Van Buren County,7203,114,7089,6937,6878,26,6,24,0,3,152,0.087,0.036,0.710,3.6%,71.0%
0500000US19179,19179,19,179,"Wapello County, Iowa",35625,3234,32391,31996,31157,447,90,250,43,9,395,0.227,0500000US19179,Wapello County,35437,4332,31105,30032,27295,1443,66,622,518,88,1073,0.389,0.162,0.716,16.2%,71.6%
0500000US19181,19181,19,181,"Warren County, Iowa",46225,899,45326,44870,44266,213,96,249,10,36,456,0.082,0500000US19181,Warren County,52403,1658,50745,48993,47897,452,80,380,17,167,1752,0.162,0.080,0.969,8.0%,96.9%
0500000US19183,19183,19,183,"Washington County, Iowa",21704,1138,20566,20381,20114,140,40,72,13,2,185,0.138,0500000US19183,Washington County,22565,1612,20953,20352,19958,177,19,113,3,82,601,0.212,0.074,0.532,7.4%,53.2%
0500000US19185,19185,19,185,"Wayne County, Iowa",6403,69,6334,6289,6244,17,12,15,1,0,45,0.049,0500000US19185,Wayne County,6497,61,6436,6291,6228,10,17,24,1,11,145,0.080,0.032,0.647,3.2%,64.7%
0500000US19187,19187,19,187,"Webster County, Iowa",38013,1446,36567,36018,34210,1435,90,241,7,35,549,0.187,0500000US19187,Webster County,36999,2063,34936,33647,31372,1773,112,295,16,79,1289,0.274,0.087,0.467,8.7%,46.7%
0500000US19189,19189,19,189,"Winnebago County, Iowa",10866,360,10506,10432,10247,78,18,85,1,3,74,0.109,0500000US19189,Winnebago County,10679,594,10085,9823,9472,204,13,94,3,37,262,0.209,0.100,0.911,10.0%,91.1%
0500000US19191,19191,19,191,"Winneshiek County, Iowa",21056,418,20638,20522,20153,130,10,224,2,3,116,0.083,0500000US19191,Winneshiek County,20070,585,19485,19066,18705,119,19,178,12,33,419,0.130,0.047,0.560,4.7%,56.0%
0500000US19193,19193,19,193,"Woodbury County, Iowa",102172,13993,88179,86012,79282,2384,1789,2395,102,60,2167,0.377,0500000US19193,Woodbury County,105941,18746,87195,83172,72237,5076,1893,2957,651,358,4023,0.499,0.122,0.322,12.2%,32.2%
0500000US19195,19195,19,195,"Worth County, Iowa",7598,147,7451,7392,7335,21,10,24,0,2,59,0.068,0500000US19195,Worth County,7443,211,7232,7054,6946,60,7,26,1,14,178,0.128,0.060,0.889,6.0%,88.9%
0500000US19197,19197,19,197,"Wright County, Iowa",13229,1274,11955,11839,11738,40,20,33,3,5,116,0.203,0500000US19197,Wright County,12943,2394,10549,10285,10107,73,15,67,8,15,264,0.356,0.152,0.748,15.2%,74.8%
0500000US20001,20001,20,1,"Allen County, Kansas",13371,392,12979,12700,12285,243,99,67,2,4,279,0.154,0500000US20001,Allen County,12526,502,12024,11407,10991,173,135,67,2,39,617,0.226,0.072,0.464,7.2%,46.4%
0500000US20003,20003,20,3,"Anderson County, Kansas",8102,123,7979,7892,7774,40,38,36,1,3,87,0.079,0500000US20003,Anderson County,7836,155,7681,7404,7259,26,46,47,0,26,277,0.140,0.061,0.775,6.1%,77.5%
0500000US20005,20005,20,5,"Atchison County, Kansas",16924,383,16541,16176,15152,844,86,70,8,16,365,0.195,0500000US20005,Atchison County,16348,583,15765,14923,13925,785,78,80,6,49,842,0.268,0.073,0.376,7.3%,37.6%
0500000US20007,20007,20,7,"Barber County, Kansas",4861,119,4742,4685,4608,20,24,20,0,13,57,0.101,0500000US20007,Barber County,4228,162,4066,3887,3814,7,34,16,5,11,179,0.183,0.082,0.818,8.2%,81.8%
0500000US20009,20009,20,9,"Barton County, Kansas",27674,3683,23991,23653,23092,367,111,53,8,22,338,0.286,0500000US20009,Barton County,25493,4127,21366,20440,19911,293,90,80,3,63,926,0.362,0.077,0.268,7.7%,26.8%
0500000US20011,20011,20,11,"Bourbon County, Kansas",15173,309,14864,14543,13953,409,101,69,5,6,321,0.153,0500000US20011,Bourbon County,14360,386,13974,13133,12451,454,88,98,2,40,841,0.243,0.090,0.591,9.0%,59.1%
0500000US20013,20013,20,13,"Brown County, Kansas",9984,306,9678,9413,8391,116,869,31,1,5,265,0.284,0500000US20013,Brown County,9508,352,9156,8648,7683,97,795,42,6,25,508,0.336,0.051,0.181,5.1%,18.1%
0500000US20015,20015,20,15,"Butler County, Kansas",65880,2602,63278,62091,59920,1054,586,452,31,48,1187,0.170,0500000US20015,Butler County,67380,3578,63802,59988,56846,1398,489,996,37,222,3814,0.281,0.111,0.651,11.1%,65.1%
0500000US20017,20017,20,17,"Chase County, Kansas",2790,100,2690,2652,2597,34,12,8,0,1,38,0.132,0500000US20017,Chase County,2572,222,2350,2272,2228,18,8,8,1,9,78,0.241,0.109,0.828,10.9%,82.8%
0500000US20019,20019,20,19,"Chautauqua County, Kansas",3669,87,3582,3456,3291,13,148,3,1,0,126,0.192,0500000US20019,Chautauqua County,3379,138,3241,3050,2822,23,185,18,0,2,191,0.295,0.103,0.534,10.3%,53.4%
0500000US20021,20021,20,21,"Cherokee County, Kansas",21603,424,21179,20381,19280,116,855,64,65,1,798,0.200,0500000US20021,Cherokee County,19362,514,18848,17216,16241,79,771,65,26,34,1632,0.287,0.087,0.434,8.7%,43.4%
0500000US20023,20023,20,23,"Cheyenne County, Kansas",2726,142,2584,2570,2543,2,6,19,0,0,14,0.127,0500000US20023,Cheyenne County,2616,238,2378,2252,2223,6,7,12,0,4,126,0.267,0.140,1.105,14.0%,110.5%
0500000US20025,20025,20,25,"Clark County, Kansas",2215,163,2052,1999,1967,0,11,17,2,2,53,0.205,0500000US20025,Clark County,1991,203,1788,1721,1668,1,20,24,1,7,67,0.286,0.081,0.395,8.1%,39.5%
0500000US20027,20027,20,27,"Clay County, Kansas",8535,162,8373,8280,8184,34,32,26,2,2,93,0.080,0500000US20027,Clay County,8117,218,7899,7629,7486,50,34,49,0,10,270,0.148,0.067,0.843,6.7%,84.3%
0500000US20029,20029,20,29,"Cloud County, Kansas",9533,283,9250,9143,9035,49,24,20,1,14,107,0.101,0500000US20029,Cloud County,9032,319,8713,8453,8235,123,40,40,4,11,260,0.166,0.066,0.652,6.6%,65.2%
0500000US20031,20031,20,31,"Coffey County, Kansas",8601,176,8425,8314,8176,47,57,34,0,0,111,0.096,0500000US20031,Coffey County,8360,221,8139,7815,7670,45,36,44,1,19,324,0.156,0.060,0.630,6.0%,63.0%
0500000US20033,20033,20,33,"Comanche County, Kansas",1891,73,1818,1797,1783,6,2,5,1,0,21,0.109,0500000US20033,Comanche County,1689,98,1591,1536,1520,10,2,0,1,3,55,0.186,0.076,0.698,7.6%,69.8%
0500000US20035,20035,20,35,"Cowley County, Kansas",36311,3292,33019,32050,29832,971,644,578,13,12,969,0.315,0500000US20035,Cowley County,34549,3971,30578,28469,26227,865,626,499,179,73,2109,0.406,0.091,0.288,9.1%,28.8%
0500000US20037,20037,20,37,"Crawford County, Kansas",39134,1762,37372,36493,34842,757,331,468,71,24,879,0.204,0500000US20037,Crawford County,38972,2716,36256,33928,31937,899,320,461,191,120,2328,0.319,0.115,0.563,11.5%,56.3%
0500000US20039,20039,20,39,"Decatur County, Kansas",2961,30,2931,2906,2869,17,13,7,0,0,25,0.061,0500000US20039,Decatur County,2764,76,2688,2594,2565,9,7,10,0,3,94,0.137,0.076,1.246,7.6%,124.6%
0500000US20041,20041,20,41,"Dickinson County, Kansas",19754,769,18985,18620,18312,139,82,59,11,17,365,0.139,0500000US20041,Dickinson County,18402,905,17497,16792,16451,105,74,74,20,68,705,0.197,0.058,0.419,5.8%,41.9%
0500000US20043,20043,20,43,"Doniphan County, Kansas",7945,165,7780,7622,7282,242,78,16,0,4,158,0.158,0500000US20043,Doniphan County,7510,204,7306,7025,6614,266,66,32,19,28,281,0.221,0.063,0.397,6.3%,39.7%
0500000US20045,20045,20,45,"Douglas County, Kansas",110826,5651,105175,101696,90532,4204,2636,4112,59,153,3479,0.326,0500000US20045,Douglas County,118785,8295,110490,103228,90281,5104,2579,4657,84,523,7262,0.410,0.084,0.258,8.4%,25.8%
0500000US20047,20047,20,47,"Edwards County, Kansas",3037,534,2503,2475,2446,5,11,12,0,1,28,0.320,0500000US20047,Edwards County,2907,623,2284,2190,2157,14,15,1,1,2,94,0.402,0.082,0.256,8.2%,25.6%
0500000US20049,20049,20,49,"Elk County, Kansas",2882,79,2803,2741,2694,0,33,12,1,1,62,0.125,0500000US20049,Elk County,2483,101,2382,2261,2214,1,43,3,0,0,121,0.201,0.076,0.607,7.6%,60.7%
0500000US20051,20051,20,51,"Ellis County, Kansas",28452,1299,27153,26814,26103,232,63,390,4,22,339,0.156,0500000US20051,Ellis County,28934,2016,26918,25839,25109,318,65,265,0,82,1079,0.240,0.085,0.543,8.5%,54.3%
0500000US20053,20053,20,53,"Ellsworth County, Kansas",6497,322,6175,6092,5733,299,32,24,0,4,83,0.217,0500000US20053,Ellsworth County,6376,365,6011,5779,5455,254,39,23,0,8,232,0.262,0.045,0.209,4.5%,20.9%
0500000US20055,20055,20,55,"Finney County, Kansas",36776,17182,19594,19187,17049,707,151,1207,12,61,407,0.565,0500000US20055,Finney County,38470,19883,18587,17710,14514,1362,164,1512,3,155,877,0.587,0.022,0.039,2.2%,3.9%
0500000US20057,20057,20,57,"Ford County, Kansas",33848,17321,16527,16172,14897,605,127,470,37,36,355,0.544,0500000US20057,Ford County,34287,19666,14621,13931,12455,885,101,394,6,90,690,0.538,-0.006,-0.011,-0.6%,-1.1%
0500000US20059,20059,20,59,"Franklin County, Kansas",25992,937,25055,24496,23880,320,180,99,2,15,559,0.154,0500000US20059,Franklin County,25996,1147,24849,23499,22818,303,190,103,7,78,1350,0.225,0.071,0.460,7.1%,46.0%
0500000US20061,20061,20,61,"Geary County, Kansas",34362,4252,30110,28269,20587,6015,277,1069,253,68,1841,0.591,0500000US20061,Geary County,36739,5776,30963,28050,19957,6062,207,1183,452,189,2913,0.645,0.054,0.092,5.4%,9.2%
0500000US20063,20063,20,63,"Gove County, Kansas",2695,42,2653,2639,2618,7,2,11,1,0,14,0.056,0500000US20063,Gove County,2718,83,2635,2524,2486,3,3,15,1,16,111,0.161,0.105,1.869,10.5%,186.9%
0500000US20065,20065,20,65,"Graham County, Kansas",2597,59,2538,2473,2357,96,13,6,0,1,65,0.174,0500000US20065,Graham County,2415,62,2353,2270,2179,55,8,14,0,14,83,0.183,0.010,0.056,1.0%,5.6%
0500000US20067,20067,20,67,"Grant County, Kansas",7829,3439,4390,4330,4240,31,31,26,0,2,60,0.514,0500000US20067,Grant County,7352,3862,3490,3297,3211,10,55,8,3,10,193,0.533,0.019,0.037,1.9%,3.7%
0500000US20069,20069,20,69,"Gray County, Kansas",6006,855,5151,5108,5050,22,20,13,0,3,43,0.273,0500000US20069,Gray County,5653,839,4814,4675,4629,19,5,14,0,8,139,0.307,0.034,0.125,3.4%,12.5%
0500000US20071,20071,20,71,"Greeley County, Kansas",1247,171,1076,1068,1056,3,4,4,0,1,8,0.264,0500000US20071,Greeley County,1284,199,1085,1055,1036,0,4,5,0,10,30,0.324,0.060,0.229,6.0%,22.9%
0500000US20073,20073,20,73,"Greenwood County, Kansas",6689,220,6469,6360,6257,23,61,18,0,1,109,0.124,0500000US20073,Greenwood County,6016,204,5812,5518,5406,28,32,36,1,15,294,0.189,0.065,0.529,6.5%,52.9%
0500000US20075,20075,20,75,"Hamilton County, Kansas",2690,827,1863,1838,1801,8,18,7,3,1,25,0.457,0500000US20075,Hamilton County,2518,1084,1434,1390,1361,10,12,5,0,2,44,0.522,0.065,0.142,6.5%,14.2%
0500000US20077,20077,20,77,"Harper County, Kansas",6034,298,5736,5669,5582,21,59,5,1,1,67,0.142,0500000US20077,Harper County,5485,425,5060,4825,4714,16,74,15,2,4,235,0.253,0.112,0.790,11.2%,79.0%
0500000US20079,20079,20,79,"Harvey County, Kansas",34684,3747,30937,30330,29332,530,181,253,10,24,607,0.273,0500000US20079,Harvey County,34024,4055,29969,28480,27349,596,183,260,10,82,1489,0.337,0.065,0.238,6.5%,23.8%
0500000US20081,20081,20,81,"Haskell County, Kansas",4256,1149,3107,3067,3036,4,16,10,0,1,40,0.418,0500000US20081,Haskell County,3780,1119,2661,2603,2578,9,8,1,0,7,58,0.447,0.029,0.069,2.9%,6.9%
0500000US20083,20083,20,83,"Hodgeman County, Kansas",1916,118,1798,1779,1748,20,3,8,0,0,19,0.164,0500000US20083,Hodgeman County,1723,96,1627,1580,1546,14,7,10,1,2,47,0.191,0.027,0.167,2.7%,16.7%
0500000US20085,20085,20,85,"Jackson County, Kansas",13462,438,13024,12657,11559,69,974,48,1,6,367,0.256,0500000US20085,Jackson County,13232,630,12602,11811,10534,95,1098,29,18,37,791,0.353,0.098,0.382,9.8%,38.2%
0500000US20087,20087,20,87,"Jefferson County, Kansas",19126,339,18787,18495,18170,100,166,38,6,15,292,0.097,0500000US20087,Jefferson County,18368,567,17801,16869,16549,99,124,41,27,29,932,0.185,0.088,0.907,8.8%,90.7%
0500000US20089,20089,20,89,"Jewell County, Kansas",3077,63,3014,2988,2959,4,17,6,0,2,26,0.075,0500000US20089,Jewell County,2932,62,2870,2775,2743,4,10,10,0,8,95,0.123,0.049,0.650,4.9%,65.0%
0500000US20091,20091,20,91,"Johnson County, Kansas",544179,38949,505230,494432,446044,23028,1639,22598,259,864,10798,0.319,0500000US20091,Johnson County,609863,54389,555474,525681,460399,28092,1595,32856,346,2393,29793,0.415,0.096,0.300,9.6%,30.0%
0500000US20093,20093,20,93,"Kearny County, Kansas",3977,1135,2842,2790,2726,16,37,10,1,0,52,0.448,0500000US20093,Kearny County,3983,1396,2587,2430,2378,34,10,5,1,2,157,0.519,0.071,0.157,7.1%,15.7%
0500000US20095,20095,20,95,"Kingman County, Kansas",7858,199,7659,7575,7486,13,38,36,2,0,84,0.092,0500000US20095,Kingman County,7470,268,7202,6937,6829,28,27,33,4,16,265,0.162,0.070,0.764,7.0%,76.4%
0500000US20097,20097,20,97,"Kiowa County, Kansas",2553,99,2454,2429,2378,12,22,16,1,0,25,0.131,0500000US20097,Kiowa County,2460,87,2373,2237,2158,43,10,16,4,6,136,0.226,0.095,0.728,9.5%,72.8%
0500000US20099,20099,20,99,"Labette County, Kansas",21607,875,20732,19947,18467,987,401,76,5,11,785,0.264,0500000US20099,Labette County,20184,939,19245,17482,16077,838,425,90,9,43,1763,0.354,0.089,0.339,8.9%,33.9%
0500000US20101,20101,20,101,"Lane County, Kansas",1750,74,1676,1651,1628,8,9,4,1,1,25,0.133,0500000US20101,Lane County,1574,143,1431,1385,1375,0,8,0,2,0,46,0.228,0.095,0.718,9.5%,71.8%
0500000US20103,20103,20,103,"Leavenworth County, Kansas",76227,4308,71919,69878,61226,7007,526,950,97,72,2041,0.342,0500000US20103,Leavenworth County,81881,5602,76279,71199,62503,6656,589,1060,138,253,5080,0.402,0.060,0.174,6.0%,17.4%
0500000US20105,20105,20,105,"Lincoln County, Kansas",3241,72,3169,3146,3116,8,15,6,0,1,23,0.075,0500000US20105,Lincoln County,2939,130,2809,2730,2691,6,13,8,0,12,79,0.159,0.084,1.117,8.4%,111.7%
0500000US20107,20107,20,107,"Linn County, Kansas",9656,186,9470,9333,9184,41,60,30,6,12,137,0.095,0500000US20107,Linn County,9591,238,9353,8934,8782,62,46,20,8,16,419,0.159,0.064,0.678,6.4%,67.8%
0500000US20109,20109,20,109,"Logan County, Kansas",2756,80,2676,2647,2609,16,12,10,0,0,29,0.103,0500000US20109,Logan County,2762,195,2567,2483,2457,4,0,10,2,10,84,0.203,0.100,0.972,10.0%,97.2%
0500000US20111,20111,20,111,"Lyon County, Kansas",33690,6755,26935,26374,24704,731,144,759,11,25,561,0.421,0500000US20111,Lyon County,32179,7256,24923,23736,22219,599,122,566,5,225,1187,0.470,0.049,0.118,4.9%,11.8%
0500000US20113,20113,20,113,"McPherson County, Kansas",29180,1025,28155,27726,27176,279,91,144,19,17,429,0.131,0500000US20113,McPherson County,30223,1592,28631,27448,26519,475,93,213,8,140,1183,0.225,0.094,0.720,9.4%,72.0%
0500000US20115,20115,20,115,"Marion County, Kansas",12660,296,12364,12191,11992,95,63,25,7,9,173,0.102,0500000US20115,Marion County,11823,442,11381,11016,10750,118,35,39,7,67,365,0.171,0.069,0.675,6.9%,67.5%
0500000US20117,20117,20,117,"Marshall County, Kansas",10117,193,9924,9806,9727,26,26,22,3,2,118,0.075,0500000US20117,Marshall County,10038,227,9811,9526,9410,39,23,41,0,13,285,0.120,0.045,0.596,4.5%,59.6%
0500000US20119,20119,20,119,"Meade County, Kansas",4575,676,3899,3848,3761,31,31,18,0,7,51,0.302,0500000US20119,Meade County,4055,797,3258,3118,3053,37,9,13,0,6,140,0.393,0.091,0.302,9.1%,30.2%
0500000US20121,20121,20,121,"Miami County, Kansas",32787,828,31959,31432,30708,411,169,114,8,22,527,0.122,0500000US20121,Miami County,34191,1196,32995,31309,30472,430,152,161,8,86,1686,0.202,0.080,0.659,8.0%,65.9%
0500000US20123,20123,20,123,"Mitchell County, Kansas",6373,73,6300,6258,6197,13,23,19,5,1,42,0.054,0500000US20123,Mitchell County,5796,157,5639,5482,5436,19,12,13,0,2,157,0.119,0.065,1.191,6.5%,119.1%
0500000US20125,20125,20,125,"Montgomery County, Kansas",35471,1844,33627,32101,28712,2022,1099,202,32,34,1526,0.336,0500000US20125,Montgomery County,31486,2414,29072,26337,23571,1533,946,191,24,72,2735,0.423,0.087,0.258,8.7%,25.8%
0500000US20127,20127,20,127,"Morris County, Kansas",5923,212,5711,5638,5572,25,26,14,1,0,73,0.114,0500000US20127,Morris County,5386,227,5159,4954,4897,16,10,18,1,12,205,0.170,0.057,0.498,5.7%,49.8%
0500000US20129,20129,20,129,"Morton County, Kansas",3233,623,2610,2567,2466,14,26,60,1,0,43,0.380,0500000US20129,Morton County,2701,591,2110,2019,1940,17,10,31,9,12,91,0.435,0.054,0.143,5.4%,14.3%
0500000US20131,20131,20,131,"Nemaha County, Kansas",10178,121,10057,9959,9843,51,42,15,4,4,98,0.064,0500000US20131,Nemaha County,10273,266,10007,9764,9622,64,26,35,7,10,243,0.121,0.057,0.884,5.7%,88.4%
0500000US20133,20133,20,133,"Neosho County, Kansas",16512,686,15826,15564,15136,192,147,83,2,4,262,0.158,0500000US20133,Neosho County,15904,910,14994,14140,13767,131,127,84,6,25,854,0.244,0.087,0.551,8.7%,55.1%
0500000US20135,20135,20,135,"Ness County, Kansas",3107,229,2878,2853,2828,17,3,3,0,2,25,0.166,0500000US20135,Ness County,2687,305,2382,2324,2305,2,9,2,0,6,58,0.251,0.085,0.511,8.5%,51.1%
0500000US20137,20137,20,137,"Norton County, Kansas",5671,240,5431,5371,5166,162,12,30,1,0,60,0.167,0500000US20137,Norton County,5459,311,5148,4968,4690,199,33,35,2,9,180,0.256,0.089,0.530,8.9%,53.0%
0500000US20139,20139,20,139,"Osage County, Kansas",16295,330,15965,15753,15560,44,108,35,4,2,212,0.088,0500000US20139,Osage County,15766,457,15309,14660,14505,33,43,52,3,24,649,0.151,0.063,0.725,6.3%,72.5%
0500000US20141,20141,20,141,"Osborne County, Kansas",3858,46,3812,3780,3743,8,12,17,0,0,32,0.058,0500000US20141,Osborne County,3500,66,3434,3326,3285,1,19,18,0,3,108,0.118,0.059,1.013,5.9%,101.3%
0500000US20143,20143,20,143,"Ottawa County, Kansas",6091,121,5970,5907,5828,49,20,9,0,1,63,0.084,0500000US20143,Ottawa County,5735,144,5591,5345,5268,30,22,10,0,15,246,0.154,0.070,0.832,7.0%,83.2%
0500000US20145,20145,20,145,"Pawnee County, Kansas",6973,461,6512,6409,6018,318,36,32,2,3,103,0.248,0500000US20145,Pawnee County,6253,522,5731,5479,5154,246,24,28,0,27,252,0.310,0.062,0.250,6.2%,25.0%
0500000US20147,20147,20,147,"Phillips County, Kansas",5642,121,5521,5473,5394,22,16,41,0,0,48,0.085,0500000US20147,Phillips County,4981,142,4839,4677,4620,19,22,15,1,0,162,0.138,0.052,0.614,5.2%,61.4%
0500000US20149,20149,20,149,"Pottawatomie County, Kansas",21604,957,20647,20205,19690,214,130,143,11,17,442,0.167,0500000US20149,Pottawatomie County,25348,1429,23919,22736,22065,271,109,194,27,70,1183,0.237,0.070,0.419,7.0%,41.9%
0500000US20151,20151,20,151,"Pratt County, Kansas",9656,525,9131,8984,8812,100,38,26,1,7,147,0.164,0500000US20151,Pratt County,9157,741,8416,8106,7872,106,40,45,7,36,310,0.253,0.089,0.545,8.9%,54.5%
0500000US20153,20153,20,153,"Rawlins County, Kansas",2519,80,2439,2420,2400,8,3,5,0,4,19,0.091,0500000US20153,Rawlins County,2561,159,2402,2286,2242,18,3,11,0,12,116,0.228,0.136,1.497,13.6%,149.7%
0500000US20155,20155,20,155,"Reno County, Kansas",64511,5209,59302,58109,55543,1843,374,296,18,35,1193,0.251,0500000US20155,Reno County,61898,6096,55802,53004,50316,1744,397,333,41,173,2798,0.327,0.076,0.301,7.6%,30.1%
0500000US20157,20157,20,157,"Republic County, Kansas",4980,53,4927,4901,4851,22,12,15,0,1,26,0.051,0500000US20157,Republic County,4674,91,4583,4450,4402,15,13,11,9,0,133,0.112,0.061,1.194,6.1%,119.4%
0500000US20159,20159,20,159,"Rice County, Kansas",10083,1018,9065,8894,8683,112,55,37,5,2,171,0.248,0500000US20159,Rice County,9427,1290,8137,7735,7520,130,41,30,0,14,402,0.343,0.095,0.384,9.5%,38.4%
0500000US20161,20161,20,161,"Riley County, Kansas",71115,4610,66505,64483,56571,4344,364,2960,129,115,2022,0.357,0500000US20161,Riley County,71959,7470,64489,60833,51807,4759,305,3325,224,413,3656,0.462,0.105,0.295,10.5%,29.5%
0500000US20163,20163,20,163,"Rooks County, Kansas",5181,107,5074,5034,4981,21,9,19,3,1,40,0.075,0500000US20163,Rooks County,4919,116,4803,4609,4558,28,2,5,9,7,194,0.139,0.064,0.852,6.4%,85.2%
0500000US20165,20165,20,165,"Rush County, Kansas",3307,84,3223,3197,3165,8,16,6,0,2,26,0.083,0500000US20165,Rush County,2956,132,2824,2768,2745,6,3,14,0,0,56,0.135,0.052,0.624,5.2%,62.4%
0500000US20167,20167,20,167,"Russell County, Kansas",6970,115,6855,6772,6640,53,42,33,1,3,83,0.092,0500000US20167,Russell County,6691,236,6455,6169,6039,60,29,28,0,13,286,0.182,0.090,0.982,9.0%,98.2%
0500000US20169,20169,20,169,"Saline County, Kansas",55606,5403,50203,48856,45671,1743,241,1138,21,42,1347,0.314,0500000US20169,Saline County,54303,6642,47661,44768,41506,1732,233,1109,26,162,2893,0.397,0.083,0.263,8.3%,26.3%
0500000US20171,20171,20,171,"Scott County, Kansas",4936,753,4183,4161,4097,16,26,20,1,1,22,0.288,0500000US20171,Scott County,5151,1027,4124,3948,3895,13,20,15,2,3,176,0.387,0.100,0.346,10.0%,34.6%
0500000US20173,20173,20,173,"Sedgwick County, Kansas",498365,64636,433729,418946,348434,44931,4456,20167,378,580,14783,0.484,0500000US20173,Sedgwick County,523824,82630,441194,410494,336271,45076,4450,22205,513,1979,30700,0.550,0.067,0.138,6.7%,13.8%
0500000US20175,20175,20,175,"Seward County, Kansas",22952,12990,9962,9657,8261,687,70,594,31,14,305,0.548,0500000US20175,Seward County,21964,14406,7558,7165,5928,611,66,517,1,42,393,0.495,-0.053,-0.097,-5.3%,-9.7%
0500000US20177,20177,20,177,"Shawnee County, Kansas",177934,19303,158631,153233,134549,14598,1747,2048,119,172,5398,0.409,0500000US20177,Shawnee County,178909,23861,155048,144218,125873,13531,1575,2480,162,597,10830,0.478,0.069,0.169,6.9%,16.9%
0500000US20179,20179,20,179,"Sheridan County, Kansas",2556,84,2472,2450,2436,3,6,5,0,0,22,0.091,0500000US20179,Sheridan County,2447,145,2302,2234,2212,0,7,12,2,1,68,0.179,0.088,0.972,8.8%,97.2%
0500000US20181,20181,20,181,"Sherman County, Kansas",6010,647,5363,5284,5214,34,14,16,6,0,79,0.236,0500000US20181,Sherman County,5927,773,5154,4942,4798,103,12,13,1,15,212,0.326,0.091,0.384,9.1%,38.4%
0500000US20183,20183,20,183,"Smith County, Kansas",3853,57,3796,3744,3712,10,11,7,3,1,52,0.071,0500000US20183,Smith County,3570,67,3503,3411,3370,12,15,9,0,5,92,0.108,0.036,0.510,3.6%,51.0%
0500000US20185,20185,20,185,"Stafford County, Kansas",4437,529,3908,3862,3805,10,30,16,1,0,46,0.250,0500000US20185,Stafford County,4072,503,3569,3413,3364,14,21,12,0,2,156,0.301,0.051,0.202,5.1%,20.2%
0500000US20187,20187,20,187,"Stanton County, Kansas",2235,828,1407,1386,1351,12,21,1,1,0,21,0.497,0500000US20187,Stanton County,2084,909,1175,1104,1074,7,21,2,0,0,71,0.543,0.046,0.092,4.6%,9.2%
0500000US20189,20189,20,189,"Stevens County, Kansas",5724,1866,3858,3814,3744,14,37,15,0,4,44,0.466,0500000US20189,Stevens County,5250,2020,3230,3085,3007,20,20,22,0,16,145,0.523,0.057,0.123,5.7%,12.3%
0500000US20191,20191,20,191,"Sumner County, Kansas",24132,1097,23035,22576,22044,211,255,50,4,12,459,0.163,0500000US20191,Sumner County,22382,1254,21128,19928,19347,200,215,73,0,93,1200,0.247,0.084,0.513,8.4%,51.3%
0500000US20193,20193,20,193,"Thomas County, Kansas",7900,370,7530,7463,7336,47,24,38,6,12,67,0.135,0500000US20193,Thomas County,7930,632,7298,7099,6910,106,12,47,0,24,199,0.233,0.098,0.725,9.8%,72.5%
0500000US20195,20195,20,195,"Trego County, Kansas",3001,51,2950,2933,2902,13,6,7,2,3,17,0.065,0500000US20195,Trego County,2808,64,2744,2649,2627,4,4,12,0,2,95,0.123,0.059,0.907,5.9%,90.7%
0500000US20197,20197,20,197,"Wabaunsee County, Kansas",7053,205,6848,6737,6664,28,33,10,0,2,111,0.106,0500000US20197,Wabaunsee County,6877,317,6560,6282,6185,31,29,12,4,21,278,0.187,0.081,0.765,8.1%,76.5%
0500000US20199,20199,20,199,"Wallace County, Kansas",1485,108,1377,1365,1354,2,7,1,0,1,12,0.163,0500000US20199,Wallace County,1512,80,1432,1353,1344,3,1,0,2,3,79,0.204,0.041,0.252,4.1%,25.2%
0500000US20201,20201,20,201,"Washington County, Kansas",5799,144,5655,5608,5558,23,8,19,0,0,47,0.081,0500000US20201,Washington County,5530,275,5255,5111,5084,13,2,4,2,6,144,0.152,0.071,0.880,7.1%,88.0%
0500000US20203,20203,20,203,"Wichita County, Kansas",2234,550,1684,1669,1647,14,5,3,0,0,15,0.396,0500000US20203,Wichita County,2152,636,1516,1429,1412,1,8,0,2,6,87,0.480,0.085,0.214,8.5%,21.4%
0500000US20205,20205,20,205,"Wilson County, Kansas",9409,217,9192,9020,8866,30,77,36,5,6,172,0.111,0500000US20205,Wilson County,8624,261,8363,7843,7679,21,79,35,2,27,520,0.202,0.091,0.822,9.1%,82.2%
0500000US20207,20207,20,207,"Woodson County, Kansas",3309,69,3240,3180,3139,12,26,2,0,1,60,0.099,0500000US20207,Woodson County,3115,71,3044,2906,2864,8,27,0,0,7,138,0.152,0.053,0.532,5.3%,53.2%
0500000US20209,20209,20,209,"Wyandotte County, Kansas",157505,41633,115872,112225,68170,39046,793,3886,147,183,3647,0.680,0500000US20209,Wyandotte County,169245,55814,113431,106307,63079,33945,725,7621,364,573,7124,0.708,0.028,0.041,2.8%,4.1%
0500000US21001,21001,21,1,"Adair County, Kentucky",18656,319,18337,18151,17558,501,36,43,4,9,186,0.113,0500000US21001,Adair County,18903,643,18260,17707,17044,498,26,63,6,70,553,0.184,0.071,0.629,7.1%,62.9%
0500000US21003,21003,21,3,"Allen County, Kentucky",19956,297,19659,19455,19203,159,55,31,0,7,204,0.074,0500000US21003,Allen County,20588,574,20014,19325,18987,204,38,48,7,41,689,0.147,0.074,1.003,7.4%,100.3%
0500000US21005,21005,21,5,"Anderson County, Kentucky",21421,288,21133,20891,20314,427,29,104,3,14,242,0.100,0500000US21005,Anderson County,23852,521,23331,22362,21654,482,50,104,4,68,969,0.173,0.073,0.733,7.3%,73.3%
0500000US21007,21007,21,7,"Ballard County, Kentucky",8249,90,8159,8025,7762,238,11,13,1,0,134,0.113,0500000US21007,Ballard County,7728,93,7635,7323,7074,208,7,29,0,5,312,0.160,0.046,0.408,4.6%,40.8%
0500000US21009,21009,21,9,"Barren County, Kentucky",42173,1110,41063,40502,38597,1617,62,181,5,40,561,0.160,0500000US21009,Barren County,44485,1889,42596,41042,38804,1697,73,255,53,160,1554,0.235,0.075,0.466,7.5%,46.6%
0500000US21011,21011,21,11,"Bath County, Kentucky",11591,157,11434,11322,11130,152,18,17,2,3,112,0.078,0500000US21011,Bath County,12750,182,12568,12288,12125,127,4,16,1,15,280,0.095,0.017,0.224,1.7%,22.4%
0500000US21013,21013,21,13,"Bell County, Kentucky",28691,198,28493,28071,27297,633,48,77,3,13,422,0.094,0500000US21013,Bell County,24097,244,23853,23079,22311,552,32,122,4,58,774,0.141,0.047,0.500,4.7%,50.0%
0500000US21015,21015,21,15,"Boone County, Kentucky",118811,4205,114606,112811,106955,2928,192,2514,76,146,1795,0.187,0500000US21015,Boone County,135968,7707,128261,122225,112602,5609,194,3048,307,465,6036,0.307,0.120,0.640,12.0%,64.0%
0500000US21017,21017,21,17,"Bourbon County, Kentucky",19985,1368,18617,18323,17027,1187,26,59,0,24,294,0.266,0500000US21017,Bourbon County,20252,1486,18766,17986,16770,1033,28,77,8,70,780,0.305,0.039,0.147,3.9%,14.7%
0500000US21019,21019,21,19,"Boyd County, Kentucky",49542,714,48828,48216,46463,1374,99,222,3,55,612,0.119,0500000US21019,Boyd County,48261,714,47547,45829,44035,1306,89,277,6,116,1718,0.165,0.046,0.385,4.6%,38.5%
0500000US21021,21021,21,21,"Boyle County, Kentucky",28432,796,27636,27124,24704,2106,47,211,7,49,512,0.238,0500000US21021,Boyle County,30614,1490,29124,27728,25074,2155,38,361,3,97,1396,0.320,0.081,0.341,8.1%,34.1%
0500000US21023,21023,21,23,"Bracken County, Kentucky",8488,96,8392,8305,8251,29,17,5,0,3,87,0.055,0500000US21023,Bracken County,8400,90,8310,8045,7964,48,14,13,0,6,265,0.100,0.045,0.824,4.5%,82.4%
0500000US21025,21025,21,25,"Breathitt County, Kentucky",13878,89,13789,13718,13575,43,12,67,12,9,71,0.043,0500000US21025,Breathitt County,13718,93,13625,13154,13038,57,11,37,11,0,471,0.095,0.052,1.215,5.2%,121.5%
0500000US21027,21027,21,27,"Breckinridge County, Kentucky",20059,175,19884,19649,19134,404,58,42,2,9,235,0.089,0500000US21027,Breckinridge County,20432,284,20148,19313,18743,422,43,38,3,64,835,0.156,0.067,0.746,6.7%,74.6%
0500000US21029,21029,21,29,"Bullitt County, Kentucky",74319,1038,73281,72496,71368,472,223,369,19,45,785,0.077,0500000US21029,Bullitt County,82217,2117,80100,76635,74787,1031,177,445,23,172,3465,0.170,0.092,1.194,9.2%,119.4%
0500000US21031,21031,21,31,"Butler County, Kentucky",12690,322,12368,12270,12182,47,20,19,0,2,98,0.078,0500000US21031,Butler County,12371,592,11779,11454,11370,15,22,21,3,23,325,0.152,0.075,0.959,7.5%,95.9%
0500000US21033,21033,21,33,"Caldwell County, Kentucky",12984,129,12855,12684,11952,664,15,33,2,18,171,0.150,0500000US21033,Caldwell County,12649,198,12451,11949,11190,654,21,53,2,29,502,0.213,0.063,0.421,6.3%,42.1%
0500000US21035,21035,21,35,"Calloway County, Kentucky",37191,890,36301,35802,33672,1375,67,650,7,31,499,0.178,0500000US21035,Calloway County,37103,1353,35750,34135,32235,1293,53,433,11,110,1615,0.241,0.063,0.353,6.3%,35.3%
0500000US21037,21037,21,37,"Campbell County, Kentucky",90336,1495,88841,87592,84406,2253,99,720,15,99,1249,0.126,0500000US21037,Campbell County,93076,2309,90767,87080,82743,2796,117,1024,30,370,3687,0.206,0.081,0.641,8.1%,64.1%
0500000US21039,21039,21,39,"Carlisle County, Kentucky",5104,83,5021,4980,4906,35,23,14,0,2,41,0.076,0500000US21039,Carlisle County,4826,133,4693,4539,4443,59,27,10,0,0,154,0.150,0.075,0.988,7.5%,98.8%
0500000US21041,21041,21,41,"Carroll County, Kentucky",10811,789,10022,9828,9575,160,25,58,2,8,194,0.210,0500000US21041,Carroll County,10810,795,10015,9648,9401,169,20,44,3,11,367,0.237,0.027,0.130,2.7%,13.0%
0500000US21043,21043,21,43,"Carter County, Kentucky",27720,321,27399,27194,26930,145,65,46,2,6,205,0.056,0500000US21043,Carter County,26627,254,26373,25769,25425,209,45,58,1,31,604,0.088,0.032,0.565,3.2%,56.5%
0500000US21045,21045,21,45,"Casey County, Kentucky",15955,378,15577,15462,15326,80,27,27,0,2,115,0.077,0500000US21045,Casey County,15941,539,15402,15052,14836,81,42,52,1,40,350,0.132,0.056,0.724,5.6%,72.4%
0500000US21047,21047,21,47,"Christian County, Kentucky",73955,4541,69414,67563,50709,15445,331,728,271,79,1851,0.482,0500000US21047,Christian County,72748,5752,66996,63323,46400,15221,272,939,211,280,3673,0.540,0.059,0.122,5.9%,12.2%
0500000US21049,21049,21,49,"Clark County, Kentucky",35613,891,34722,34302,32407,1693,48,125,4,25,420,0.169,0500000US21049,Clark County,36972,1477,35495,34267,32267,1635,63,209,14,79,1228,0.234,0.065,0.383,6.5%,38.3%
0500000US21051,21051,21,51,"Clay County, Kentucky",21730,402,21328,21155,20189,900,32,26,3,5,173,0.135,0500000US21051,Clay County,20345,353,19992,19581,18686,816,26,21,11,21,411,0.154,0.019,0.144,1.9%,14.4%
0500000US21053,21053,21,53,"Clinton County, Kentucky",10272,231,10041,9945,9865,39,18,13,7,3,96,0.077,0500000US21053,Clinton County,9253,245,9008,8757,8680,39,10,10,3,15,251,0.119,0.041,0.538,4.1%,53.8%
0500000US21055,21055,21,55,"Crittenden County, Kentucky",9315,48,9267,9202,9065,76,32,17,7,5,65,0.053,0500000US21055,Crittenden County,8990,113,8877,8648,8524,82,15,5,5,17,229,0.100,0.047,0.896,4.7%,89.6%
0500000US21057,21057,21,57,"Cumberland County, Kentucky",6856,63,6793,6706,6508,177,6,8,0,7,87,0.098,0500000US21057,Cumberland County,5888,77,5811,5610,5445,150,1,2,6,6,201,0.143,0.045,0.457,4.5%,45.7%
0500000US21059,21059,21,59,"Daviess County, Kentucky",96656,2525,94131,92594,87005,4583,112,670,47,177,1537,0.186,0500000US21059,Daviess County,103312,4145,99167,95071,87327,4827,130,2417,59,311,4096,0.280,0.093,0.499,9.3%,49.9%
0500000US21061,21061,21,61,"Edmonson County, Kentucky",12161,100,12061,11962,11733,166,37,25,1,0,99,0.069,0500000US21061,Edmonson County,12126,156,11970,11661,11486,98,31,32,7,7,309,0.102,0.033,0.480,3.3%,48.0%
0500000US21063,21063,21,63,"Elliott County, Kentucky",7852,62,7790,7757,7473,262,9,4,7,2,33,0.093,0500000US21063,Elliott County,7354,91,7263,7160,6875,246,14,10,0,15,103,0.125,0.032,0.339,3.2%,33.9%
0500000US21065,21065,21,65,"Estill County, Kentucky",14672,101,14571,14486,14407,28,30,14,0,7,85,0.036,0500000US21065,Estill County,14163,131,14032,13690,13619,30,23,7,0,11,342,0.075,0.039,1.091,3.9%,109.1%
0500000US21067,21067,21,67,"Fayette County, Kentucky",295803,20474,275329,269166,216072,42336,599,9506,107,546,6163,0.440,0500000US21067,Fayette County,322570,29750,292820,278498,215343,47501,480,13374,133,1667,14322,0.520,0.081,0.184,8.1%,18.4%
0500000US21069,21069,21,69,"Fleming County, Kentucky",14348,149,14199,14093,13858,181,11,32,1,10,106,0.067,0500000US21069,Fleming County,15082,218,14864,14546,14314,148,22,17,3,42,318,0.098,0.032,0.474,3.2%,47.4%
0500000US21071,21071,21,71,"Floyd County, Kentucky",39451,219,39232,39034,38624,292,39,75,0,4,198,0.041,0500000US21071,Floyd County,35942,308,35634,34934,34654,121,28,96,1,34,700,0.070,0.029,0.690,2.9%,69.0%
0500000US21073,21073,21,73,"Franklin County, Kentucky",49285,1374,47911,46952,41026,5078,82,692,7,67,959,0.295,0500000US21073,Franklin County,51541,2047,49494,47074,41282,4444,91,1031,14,212,2420,0.347,0.052,0.175,5.2%,17.5%
0500000US21075,21075,21,75,"Fulton County, Kentucky",6813,53,6760,6649,4973,1607,17,45,2,5,111,0.411,0500000US21075,Fulton County,6515,151,6364,6067,4566,1433,13,17,11,27,297,0.458,0.047,0.113,4.7%,11.3%
0500000US21077,21077,21,77,"Gallatin County, Kentucky",8589,372,8217,8093,7952,109,9,15,3,5,124,0.141,0500000US21077,Gallatin County,8690,492,8198,7871,7762,74,4,13,7,11,327,0.197,0.057,0.405,5.7%,40.5%
0500000US21079,21079,21,79,"Garrard County, Kentucky",16912,403,16509,16377,15965,339,22,37,1,13,132,0.108,0500000US21079,Garrard County,16953,451,16502,15857,15433,301,27,51,8,37,645,0.169,0.061,0.566,6.1%,56.6%
0500000US21081,21081,21,81,"Grant County, Kentucky",24662,577,24085,23894,23545,173,49,78,32,17,191,0.088,0500000US21081,Grant County,24941,741,24200,23208,22823,179,51,66,33,56,992,0.160,0.072,0.822,7.2%,82.2%
0500000US21083,21083,21,83,"Graves County, Kentucky",37121,2099,35022,34437,32608,1597,70,124,11,27,585,0.223,0500000US21083,Graves County,36649,2773,33876,32426,30527,1551,96,173,3,76,1450,0.297,0.074,0.332,7.4%,33.2%
0500000US21085,21085,21,85,"Grayson County, Kentucky",25746,258,25488,25257,24885,260,41,61,3,7,231,0.065,0500000US21085,Grayson County,26420,364,26056,25308,24756,308,71,96,2,75,748,0.121,0.055,0.846,5.5%,84.6%
0500000US21087,21087,21,87,"Green County, Kentucky",11258,159,11099,10978,10691,222,34,17,1,13,121,0.097,0500000US21087,Green County,11107,199,10908,10596,10361,160,17,28,2,28,312,0.128,0.031,0.318,3.1%,31.8%
0500000US21089,21089,21,89,"Greenup County, Kentucky",36910,284,36626,36294,35752,255,86,184,1,16,332,0.062,0500000US21089,Greenup County,35962,317,35645,34579,33974,219,68,230,5,83,1066,0.106,0.045,0.730,4.5%,73.0%
0500000US21091,21091,21,91,"Hancock County, Kentucky",8565,94,8471,8388,8282,70,15,19,0,2,83,0.065,0500000US21091,Hancock County,9095,162,8933,8717,8586,79,4,34,0,14,216,0.108,0.043,0.666,4.3%,66.6%
0500000US21093,21093,21,93,"Hardin County, Kentucky",105543,5317,100226,97070,82139,11878,482,2067,333,171,3156,0.378,0500000US21093,Hardin County,110702,6695,104007,97213,81085,12510,378,2243,400,597,6794,0.443,0.065,0.172,6.5%,17.2%
0500000US21095,21095,21,95,"Harlan County, Kentucky",29278,210,29068,28810,28030,639,36,100,2,3,258,0.083,0500000US21095,Harlan County,26831,265,26566,25729,25001,541,54,85,0,48,837,0.130,0.047,0.573,4.7%,57.3%
0500000US21097,21097,21,97,"Harrison County, Kentucky",18846,337,18509,18315,17846,379,35,37,11,7,194,0.102,0500000US21097,Harrison County,18692,387,18305,17643,17216,307,26,46,1,47,662,0.150,0.047,0.461,4.7%,46.1%
0500000US21099,21099,21,99,"Hart County, Kentucky",18199,261,17938,17741,16771,883,30,36,1,20,197,0.148,0500000US21099,Hart County,19288,334,18954,18311,17492,705,33,45,6,30,643,0.175,0.027,0.180,2.7%,18.0%
0500000US21101,21101,21,101,"Henderson County, Kentucky",46250,858,45392,44681,40773,3568,79,193,9,59,711,0.216,0500000US21101,Henderson County,44793,1368,43425,41480,37323,3632,78,239,41,167,1945,0.296,0.080,0.370,8.0%,37.0%
0500000US21103,21103,21,103,"Henry County, Kentucky",15416,447,14969,14760,14272,410,35,29,8,6,209,0.141,0500000US21103,Henry County,15678,545,15133,14539,14065,349,45,35,0,45,594,0.192,0.051,0.360,5.1%,36.0%
0500000US21105,21105,21,105,"Hickman County, Kentucky",4902,57,4845,4779,4298,451,12,11,1,6,66,0.222,0500000US21105,Hickman County,4521,102,4419,4264,3866,380,6,11,0,1,155,0.260,0.038,0.169,3.8%,16.9%
0500000US21107,21107,21,107,"Hopkins County, Kentucky",46920,734,46186,45360,41940,3069,56,257,15,23,826,0.196,0500000US21107,Hopkins County,45423,1126,44297,42404,39054,2902,70,230,29,119,1893,0.254,0.058,0.296,5.8%,29.6%
0500000US21109,21109,21,109,"Jackson County, Kentucky",13494,84,13410,13341,13298,13,17,11,0,2,69,0.029,0500000US21109,Jackson County,12955,96,12859,12591,12509,12,36,19,4,11,268,0.067,0.038,1.335,3.8%,133.5%
0500000US21111,21111,21,111,"Jefferson County, Kentucky",741096,32542,708554,694333,522561,152451,1492,16171,403,1255,14221,0.458,0500000US21111,Jefferson County,782969,59021,723948,689969,490251,167067,1441,26944,559,3707,33979,0.554,0.096,0.210,9.6%,21.0%
0500000US21113,21113,21,113,"Jessamine County, Kentucky",48586,1353,47233,46464,44336,1487,114,475,15,37,769,0.165,0500000US21113,Jessamine County,52991,2384,50607,48402,45191,2247,106,658,27,173,2205,0.267,0.102,0.616,10.2%,61.6%
0500000US21115,21115,21,115,"Johnson County, Kentucky",23356,109,23247,23080,22900,56,28,91,4,1,167,0.039,0500000US21115,Johnson County,22680,198,22482,22062,21860,42,39,101,4,16,420,0.071,0.032,0.829,3.2%,82.9%
0500000US21117,21117,21,117,"Kenton County, Kentucky",159720,4225,155495,152728,143430,7267,235,1398,139,259,2767,0.190,0500000US21117,Kenton County,169064,7741,161323,153267,142167,8061,234,2015,241,549,8056,0.286,0.096,0.502,9.6%,50.2%
0500000US21119,21119,21,119,"Knott County, Kentucky",16346,99,16247,16162,16015,116,9,14,2,6,85,0.040,0500000US21119,Knott County,14251,90,14161,13911,13813,65,8,18,0,7,250,0.060,0.020,0.505,2.0%,50.5%
0500000US21121,21121,21,121,"Knox County, Kentucky",31883,270,31613,31301,30805,344,68,67,3,14,312,0.066,0500000US21121,Knox County,30193,347,29846,28992,28509,281,82,85,1,34,854,0.107,0.041,0.623,4.1%,62.3%
0500000US21123,21123,21,123,"Larue County, Kentucky",14193,401,13792,13601,13096,441,35,25,2,2,191,0.147,0500000US21123,Larue County,14867,479,14388,13814,13299,377,47,29,15,47,574,0.197,0.050,0.341,5.0%,34.1%
0500000US21125,21125,21,125,"Laurel County, Kentucky",58849,717,58132,57595,56732,405,145,286,2,25,537,0.070,0500000US21125,Laurel County,62613,1011,61602,59613,58503,440,143,426,4,97,1989,0.126,0.055,0.786,5.5%,78.6%
0500000US21127,21127,21,127,"Lawrence County, Kentucky",15860,77,15783,15660,15582,32,17,26,1,2,123,0.035,0500000US21127,Lawrence County,16293,148,16145,15811,15721,36,2,23,4,25,334,0.068,0.034,0.976,3.4%,97.6%
0500000US21129,21129,21,129,"Lee County, Kentucky",7887,58,7829,7781,7564,185,20,11,0,1,48,0.080,0500000US21129,Lee County,7395,60,7335,7187,6887,280,1,0,0,19,148,0.131,0.051,0.643,5.1%,64.3%
0500000US21131,21131,21,131,"Leslie County, Kentucky",11310,40,11270,11205,11152,22,11,15,1,4,65,0.028,0500000US21131,Leslie County,10513,72,10441,10243,10170,39,15,15,0,4,198,0.064,0.036,1.303,3.6%,130.3%
0500000US21133,21133,21,133,"Letcher County, Kentucky",24519,124,24395,24285,24120,85,34,39,0,7,110,0.032,0500000US21133,Letcher County,21548,133,21415,20974,20773,87,30,57,0,27,441,0.070,0.038,1.177,3.8%,117.7%
0500000US21135,21135,21,135,"Lewis County, Kentucky",13870,78,13792,13722,13650,35,27,8,0,2,70,0.031,0500000US21135,Lewis County,13080,83,12997,12672,12599,36,18,9,4,6,325,0.072,0.040,1.278,4.0%,127.8%
0500000US21137,21137,21,137,"Lincoln County, Kentucky",24742,372,24370,24057,23404,560,39,39,1,14,313,0.104,0500000US21137,Lincoln County,24275,475,23800,23093,22493,459,33,60,2,46,707,0.140,0.036,0.340,3.6%,34.0%
0500000US21139,21139,21,139,"Livingston County, Kentucky",9519,123,9396,9311,9243,16,24,18,6,4,85,0.057,0500000US21139,Livingston County,8888,186,8702,8308,8232,25,19,12,6,14,394,0.140,0.083,1.457,8.3%,145.7%
0500000US21141,21141,21,141,"Logan County, Kentucky",26835,651,26184,25822,23934,1734,44,64,11,35,362,0.200,0500000US21141,Logan County,27432,853,26579,25593,23681,1680,43,95,2,92,986,0.249,0.049,0.246,4.9%,24.6%
0500000US21143,21143,21,143,"Lyon County, Kentucky",8314,77,8237,8155,7672,437,12,24,1,9,82,0.146,0500000US21143,Lyon County,8680,152,8528,8320,7733,507,25,34,0,21,208,0.202,0.056,0.388,5.6%,38.8%
0500000US21145,21145,21,145,"McCracken County, Kentucky",65565,1383,64182,62925,55025,7179,126,521,10,64,1257,0.283,0500000US21145,McCracken County,67875,2135,65740,62411,53801,7539,170,660,18,223,3329,0.356,0.073,0.258,7.3%,25.8%
0500000US21147,21147,21,147,"McCreary County, Kentucky",18306,392,17914,17687,16557,977,122,25,4,2,227,0.178,0500000US21147,McCreary County,16888,365,16523,16090,15072,908,58,32,3,17,433,0.199,0.021,0.118,2.1%,11.8%
0500000US21149,21149,21,149,"McLean County, Kentucky",9531,106,9425,9364,9278,53,22,10,0,1,61,0.052,0500000US21149,McLean County,9152,164,8988,8791,8691,47,10,13,2,28,197,0.097,0.045,0.866,4.5%,86.6%
0500000US21151,21151,21,151,"Madison County, Kentucky",82916,1813,81103,79656,74967,3565,225,753,30,116,1447,0.180,0500000US21151,Madison County,92701,3064,89637,84983,79591,3880,190,1006,56,260,4654,0.257,0.078,0.431,7.8%,43.1%
0500000US21153,21153,21,153,"Magoffin County, Kentucky",13333,95,13238,13165,13106,18,30,8,0,3,73,0.034,0500000US21153,Magoffin County,11637,66,11571,11387,11335,14,14,5,6,13,184,0.051,0.017,0.513,1.7%,51.3%
0500000US21155,21155,21,155,"Marion County, Kentucky",19820,482,19338,19042,17285,1593,26,115,2,21,296,0.232,0500000US21155,Marion County,19581,681,18900,18211,16779,1209,0,123,47,53,689,0.259,0.027,0.117,2.7%,11.7%
0500000US21157,21157,21,157,"Marshall County, Kentucky",31448,350,31098,30870,30669,48,55,83,2,13,228,0.049,0500000US21157,Marshall County,31659,539,31120,30041,29697,101,60,129,9,45,1079,0.119,0.070,1.434,7.0%,143.4%
0500000US21159,21159,21,159,"Martin County, Kentucky",12929,388,12541,12481,11533,882,44,22,0,0,60,0.199,0500000US21159,Martin County,11287,290,10997,10843,10002,780,42,17,1,1,154,0.209,0.010,0.052,1.0%,5.2%
0500000US21161,21161,21,161,"Mason County, Kentucky",17490,248,17242,16958,15686,1117,33,99,1,22,284,0.191,0500000US21161,Mason County,17120,356,16764,15973,14777,1017,29,107,0,43,791,0.249,0.058,0.302,5.8%,30.2%
0500000US21163,21163,21,163,"Meade County, Kentucky",28602,859,27743,27145,25905,899,133,154,34,20,598,0.177,0500000US21163,Meade County,30003,1133,28870,27407,25912,952,132,217,73,121,1463,0.249,0.072,0.405,7.2%,40.5%
0500000US21165,21165,21,165,"Menifee County, Kentucky",6306,51,6255,6186,6056,112,6,7,0,5,69,0.077,0500000US21165,Menifee County,6113,57,6056,5920,5873,30,12,2,2,1,136,0.076,-0.001,-0.011,-0.1%,-1.1%
0500000US21167,21167,21,167,"Mercer County, Kentucky",21331,490,20841,20497,19614,751,29,76,10,17,344,0.152,0500000US21167,Mercer County,22641,703,21938,21058,20100,748,40,74,14,82,880,0.208,0.056,0.366,5.6%,36.6%
0500000US21169,21169,21,169,"Metcalfe County, Kentucky",10099,115,9984,9907,9730,153,11,12,0,1,77,0.071,0500000US21169,Metcalfe County,10286,230,10056,9777,9620,114,3,7,0,33,279,0.124,0.053,0.738,5.3%,73.8%
0500000US21171,21171,21,171,"Monroe County, Kentucky",10963,289,10674,10567,10314,231,12,8,0,2,107,0.114,0500000US21171,Monroe County,11338,473,10865,10651,10389,218,9,10,0,25,214,0.158,0.044,0.389,4.4%,38.9%
0500000US21173,21173,21,173,"Montgomery County, Kentucky",26499,660,25839,25600,24715,712,40,83,6,44,239,0.129,0500000US21173,Montgomery County,28114,925,27189,26214,25363,614,26,145,1,65,975,0.183,0.055,0.425,5.5%,42.5%
0500000US21175,21175,21,175,"Morgan County, Kentucky",13923,108,13815,13722,13048,598,30,42,1,3,93,0.120,0500000US21175,Morgan County,13726,417,13309,13053,12510,492,20,17,4,10,256,0.167,0.047,0.392,4.7%,39.2%
0500000US21177,21177,21,177,"Muhlenberg County, Kentucky",31499,367,31132,30832,29301,1417,46,43,4,21,300,0.132,0500000US21177,Muhlenberg County,30928,569,30359,29594,28204,1203,64,58,3,62,765,0.166,0.033,0.253,3.3%,25.3%
0500000US21179,21179,21,179,"Nelson County, Kentucky",43437,888,42549,41963,39498,2168,49,216,8,24,586,0.170,0500000US21179,Nelson County,46738,1214,45524,43758,41113,2183,62,267,8,125,1766,0.222,0.052,0.305,5.2%,30.5%
0500000US21181,21181,21,181,"Nicholas County, Kentucky",7135,98,7037,6990,6922,41,7,16,0,4,47,0.059,0500000US21181,Nicholas County,7537,154,7383,7198,7124,41,10,7,2,14,185,0.106,0.047,0.803,4.7%,80.3%
0500000US21183,21183,21,183,"Ohio County, Kentucky",23842,844,22998,22813,22531,187,39,47,5,4,185,0.106,0500000US21183,Ohio County,23772,993,22779,22154,21872,155,26,45,2,54,625,0.151,0.045,0.430,4.5%,43.0%
0500000US21185,21185,21,185,"Oldham County, Kentucky",60316,2133,58183,57371,53796,2571,142,785,19,58,812,0.201,0500000US21185,Oldham County,67607,3235,64372,61533,57836,2198,108,1160,17,214,2839,0.263,0.062,0.307,6.2%,30.7%
0500000US21187,21187,21,187,"Owen County, Kentucky",10841,246,10595,10500,10367,90,15,17,1,10,95,0.085,0500000US21187,Owen County,11278,251,11027,10630,10486,83,22,18,4,17,397,0.134,0.049,0.576,4.9%,57.6%
0500000US21189,21189,21,189,"Owsley County, Kentucky",4755,39,4716,4689,4659,13,12,2,0,3,27,0.040,0500000US21189,Owsley County,4051,42,4009,3927,3905,11,1,1,5,4,82,0.070,0.030,0.763,3.0%,76.3%
0500000US21191,21191,21,191,"Pendleton County, Kentucky",14877,143,14734,14616,14521,47,25,20,1,2,118,0.047,0500000US21191,Pendleton County,14644,201,14443,13985,13833,56,21,30,3,42,458,0.106,0.059,1.260,5.9%,126.0%
0500000US21193,21193,21,193,"Perry County, Kentucky",28712,185,28527,28252,27622,432,36,148,4,10,275,0.074,0500000US21193,Perry County,28473,221,28252,27458,26748,374,51,255,1,29,794,0.116,0.042,0.571,4.2%,57.1%
0500000US21195,21195,21,195,"Pike County, Kentucky",65024,446,64578,64159,63431,348,59,291,8,22,419,0.048,0500000US21195,Pike County,58669,695,57974,56660,55635,485,68,369,11,92,1314,0.100,0.052,1.072,5.2%,107.2%
0500000US21197,21197,21,197,"Powell County, Kentucky",12613,132,12481,12378,12264,78,14,17,4,1,103,0.054,0500000US21197,Powell County,13129,197,12932,12641,12507,64,17,30,0,23,291,0.092,0.037,0.688,3.7%,68.8%
0500000US21199,21199,21,199,"Pulaski County, Kentucky",63063,1318,61745,61127,59943,705,128,289,13,49,618,0.096,0500000US21199,Pulaski County,65034,1877,63157,61033,59600,677,160,436,10,150,2124,0.158,0.062,0.650,6.2%,65.0%
0500000US21201,21201,21,201,"Robertson County, Kentucky",2282,22,2260,2239,2232,3,2,2,0,0,21,0.043,0500000US21201,Robertson County,2193,19,2174,2122,2106,6,3,7,0,0,52,0.077,0.034,0.787,3.4%,78.7%
0500000US21203,21203,21,203,"Rockcastle County, Kentucky",17056,103,16953,16822,16741,19,41,13,1,7,131,0.036,0500000US21203,Rockcastle County,16037,172,15865,15453,15316,52,33,28,0,24,412,0.087,0.051,1.387,5.1%,138.7%
0500000US21205,21205,21,205,"Rowan County, Kentucky",23333,294,23039,22834,22266,341,33,178,4,12,205,0.089,0500000US21205,Rowan County,24662,541,24121,23444,22773,372,32,157,5,105,677,0.146,0.057,0.641,5.7%,64.1%
0500000US21207,21207,21,207,"Russell County, Kentucky",17565,585,16980,16830,16676,79,34,40,0,1,150,0.097,0500000US21207,Russell County,17991,781,17210,16798,16497,113,58,104,3,23,412,0.157,0.059,0.608,5.9%,60.8%
0500000US21209,21209,21,209,"Scott County, Kentucky",47173,1994,45179,44480,41441,2433,105,412,14,75,699,0.224,0500000US21209,Scott County,57155,3103,54052,51458,47704,2907,56,587,19,185,2594,0.296,0.072,0.323,7.2%,32.3%
0500000US21211,21211,21,211,"Shelby County, Kentucky",42074,3812,38262,37559,34080,3038,92,251,31,67,703,0.330,0500000US21211,Shelby County,48065,5295,42770,40734,37363,2700,76,361,22,212,2036,0.379,0.048,0.147,4.8%,14.7%
0500000US21213,21213,21,213,"Simpson County, Kentucky",17327,325,17002,16714,14941,1615,36,111,4,7,288,0.247,0500000US21213,Simpson County,19594,648,18946,18052,16201,1622,58,94,5,72,894,0.306,0.059,0.240,5.9%,24.0%
0500000US21215,21215,21,215,"Spencer County, Kentucky",17061,239,16822,16655,16278,256,30,70,9,12,167,0.089,0500000US21215,Spencer County,19490,450,19040,18225,17764,297,32,90,12,30,815,0.167,0.078,0.870,7.8%,87.0%
0500000US21217,21217,21,217,"Taylor County, Kentucky",24512,433,24079,23727,22329,1210,29,128,10,21,352,0.167,0500000US21217,Taylor County,26023,720,25303,24366,22724,1252,26,244,10,110,937,0.233,0.066,0.393,6.6%,39.3%
0500000US21219,21219,21,219,"Todd County, Kentucky",12460,494,11966,11827,10797,989,18,10,2,11,139,0.241,0500000US21219,Todd County,12243,598,11645,11197,10234,880,14,22,6,41,448,0.292,0.051,0.212,5.1%,21.2%
0500000US21221,21221,21,221,"Trigg County, Kentucky",14339,175,14164,13940,12675,1171,37,44,4,9,224,0.212,0500000US21221,Trigg County,14061,317,13744,13253,12202,950,34,27,6,34,491,0.241,0.029,0.137,2.9%,13.7%
0500000US21223,21223,21,223,"Trimble County, Kentucky",8809,223,8586,8503,8408,21,20,37,4,13,83,0.088,0500000US21223,Trimble County,8474,192,8282,8010,7914,28,29,27,4,8,272,0.126,0.038,0.431,3.8%,43.1%
0500000US21225,21225,21,225,"Union County, Kentucky",15007,243,14764,14565,12654,1803,27,50,7,24,199,0.274,0500000US21225,Union County,13668,188,13480,12930,11802,1029,27,32,1,39,550,0.247,-0.027,-0.099,-2.7%,-9.9%
0500000US21227,21227,21,227,"Warren County, Kentucky",113792,5174,108618,106710,92807,10204,273,3151,113,162,1908,0.324,0500000US21227,Warren County,134554,9441,125113,119369,97744,12804,235,7295,661,630,5744,0.454,0.130,0.401,13.0%,40.1%
0500000US21229,21229,21,229,"Washington County, Kentucky",11717,393,11324,11192,10401,736,10,31,1,13,132,0.207,0500000US21229,Washington County,12027,470,11557,11169,10397,652,25,38,5,52,388,0.247,0.040,0.195,4.0%,19.5%
0500000US21231,21231,21,231,"Wayne County, Kentucky",20813,601,20212,20005,19591,308,33,67,3,3,207,0.113,0500000US21231,Wayne County,19555,902,18653,18210,17872,228,28,60,5,17,443,0.162,0.049,0.435,4.9%,43.5%
0500000US21233,21233,21,233,"Webster County, Kentucky",13621,580,13041,12889,12233,553,23,35,32,13,152,0.190,0500000US21233,Webster County,13017,845,12172,11712,11145,476,23,24,1,43,460,0.260,0.070,0.370,7.0%,37.0%
0500000US21235,21235,21,235,"Whitley County, Kentucky",35637,310,35327,34963,34521,205,93,123,11,10,364,0.061,0500000US21235,Whitley County,36712,687,36025,34960,34076,531,89,204,10,50,1065,0.137,0.076,1.231,7.6%,123.1%
0500000US21237,21237,21,237,"Wolfe County, Kentucky",7355,41,7314,7275,7241,10,21,3,0,0,39,0.031,0500000US21237,Wolfe County,6562,61,6501,6412,6356,27,9,5,0,15,89,0.062,0.031,1.004,3.1%,100.4%
0500000US21239,21239,21,239,"Woodford County, Kentucky",24939,1680,23259,22953,21556,1216,30,124,5,22,306,0.246,0500000US21239,Woodford County,26871,2013,24858,23843,22361,1211,28,157,10,76,1015,0.298,0.053,0.214,5.3%,21.4%
0500000US22001,22001,22,1,"Acadia Parish, Louisiana",61773,1060,60713,60028,48555,11133,155,137,5,43,685,0.349,0500000US22001,Acadia Parish,57576,1641,55935,54470,44115,9946,145,163,2,99,1465,0.382,0.032,0.093,3.2%,9.3%
0500000US22003,22003,22,3,"Allen Parish, Louisiana",25764,342,25422,25048,18276,5957,603,176,5,31,374,0.442,0500000US22003,Allen Parish,22750,1893,20857,19938,15146,4016,525,183,7,61,919,0.516,0.074,0.167,7.4%,16.7%
0500000US22005,22005,22,5,"Ascension Parish, Louisiana",107215,5024,102191,101162,75949,23727,297,995,61,133,1029,0.447,0500000US22005,Ascension Parish,126500,10383,116117,112275,79645,30296,266,1681,32,355,3842,0.538,0.092,0.205,9.2%,20.5%
0500000US22007,22007,22,7,"Assumption Parish, Louisiana",23421,498,22923,22756,15442,7111,132,56,11,4,167,0.473,0500000US22007,Assumption Parish,21039,914,20125,19709,13580,5973,83,56,0,17,416,0.500,0.028,0.059,2.8%,5.9%
0500000US22009,22009,22,9,"Avoyelles Parish, Louisiana",42073,606,41467,40845,27877,12318,471,140,3,36,622,0.475,0500000US22009,Avoyelles Parish,39693,1485,38208,36688,25236,10649,349,345,3,106,1520,0.521,0.046,0.097,4.6%,9.7%
0500000US22011,22011,22,11,"Beauregard Parish, Louisiana",35654,1003,34651,33927,28730,4597,326,217,16,41,724,0.333,0500000US22011,Beauregard Parish,36549,1271,35278,33734,29039,4082,273,222,27,91,1544,0.353,0.020,0.061,2.0%,6.1%
0500000US22013,22013,22,13,"Bienville Parish, Louisiana",14353,207,14146,13981,7850,6048,48,34,0,1,165,0.523,0500000US22013,Bienville Parish,12981,211,12770,12271,6901,5273,61,21,5,10,499,0.551,0.028,0.053,2.8%,5.3%
0500000US22015,22015,22,15,"Bossier Parish, Louisiana",116979,7026,109953,107924,80991,24245,533,1873,154,128,2029,0.473,0500000US22015,Bossier Parish,128746,10237,118509,112357,78982,29868,573,2341,113,480,6152,0.561,0.087,0.185,8.7%,18.5%
0500000US22017,22017,22,17,"Caddo Parish, Louisiana",254969,6129,248840,245659,121969,119697,976,2653,118,246,3181,0.550,0500000US22017,Caddo Parish,237848,8381,229467,221546,101727,114769,895,3179,120,856,7921,0.582,0.032,0.058,3.2%,5.8%
0500000US22019,22019,22,19,"Calcasieu Parish, Louisiana",192768,4945,187823,184671,133703,47490,836,2052,76,514,3152,0.457,0500000US22019,Calcasieu Parish,216785,11384,205401,197624,137110,54825,902,3797,137,853,7777,0.532,0.074,0.163,7.4%,16.3%
0500000US22021,22021,22,21,"Caldwell Parish, Louisiana",10132,222,9910,9826,8045,1735,19,25,0,2,84,0.340,0500000US22021,Caldwell Parish,9645,221,9424,9149,7551,1528,19,42,3,6,275,0.361,0.021,0.062,2.1%,6.2%
0500000US22023,22023,22,23,"Cameron Parish, Louisiana",6839,154,6685,6624,6465,119,33,6,0,1,61,0.105,0500000US22023,Cameron Parish,5617,197,5420,5295,5174,71,28,13,1,8,125,0.150,0.044,0.418,4.4%,41.8%
0500000US22025,22025,22,25,"Catahoula Parish, Louisiana",10407,90,10317,10255,6946,3273,33,3,0,0,62,0.455,0500000US22025,Catahoula Parish,8906,614,8292,8089,5738,2275,34,26,6,10,203,0.514,0.059,0.129,5.9%,12.9%
0500000US22027,22027,22,27,"Claiborne Parish, Louisiana",17195,171,17024,16892,8084,8707,59,39,1,2,132,0.522,0500000US22027,Claiborne Parish,14170,479,13691,13308,7064,6138,43,42,0,21,383,0.562,0.040,0.076,4.0%,7.6%
0500000US22029,22029,22,29,"Concordia Parish, Louisiana",20822,209,20613,20459,11829,8503,62,49,4,12,154,0.510,0500000US22029,Concordia Parish,18687,459,18228,17804,10157,7477,39,115,0,16,424,0.543,0.033,0.065,3.3%,6.5%
0500000US22031,22031,22,31,"De Soto Parish, Louisiana",26656,661,25995,25730,15092,10402,180,37,9,10,265,0.526,0500000US22031,De Soto Parish,26812,762,26050,25121,15122,9586,242,99,0,72,929,0.552,0.026,0.049,2.6%,4.9%
0500000US22033,22033,22,33,"East Baton Rouge Parish, Louisiana",440171,16274,423897,419169,206664,198590,923,12290,86,616,4728,0.574,0500000US22033,East Baton Rouge Parish,456781,30551,426230,413738,191355,205552,773,14388,106,1564,12492,0.616,0.042,0.073,4.2%,7.3%
0500000US22035,22035,22,35,"East Carroll Parish, Louisiana",7759,127,7632,7582,2198,5324,16,44,0,0,50,0.449,0500000US22035,East Carroll Parish,7459,115,7344,7222,2034,5164,2,17,0,5,122,0.446,-0.003,-0.006,-0.3%,-0.6%
0500000US22037,22037,22,37,"East Feliciana Parish, Louisiana",20267,208,20059,19844,10666,9052,60,51,1,14,215,0.523,0500000US22037,East Feliciana Parish,19539,391,19148,18676,11411,7108,60,46,9,42,472,0.526,0.002,0.004,0.2%,0.4%
0500000US22039,22039,22,39,"Evangeline Parish, Louisiana",33984,776,33208,32882,23071,9565,98,112,3,33,326,0.459,0500000US22039,Evangeline Parish,32350,1336,31014,30092,21162,8609,45,183,2,91,922,0.499,0.039,0.086,3.9%,8.6%
0500000US22041,22041,22,41,"Franklin Parish, Louisiana",20767,196,20571,20442,13853,6500,36,42,6,5,129,0.457,0500000US22041,Franklin Parish,19774,276,19498,19019,12430,6508,26,38,0,17,479,0.496,0.039,0.085,3.9%,8.5%
0500000US22043,22043,22,43,"Grant Parish, Louisiana",22309,931,21378,21071,17361,3441,205,53,8,3,307,0.369,0500000US22043,Grant Parish,22169,1333,20836,20046,16678,3060,193,67,6,42,790,0.410,0.041,0.112,4.1%,11.2%
0500000US22045,22045,22,45,"Iberia Parish, Louisiana",73240,2299,70941,69943,44502,23280,252,1745,18,146,998,0.528,0500000US22045,Iberia Parish,69929,3897,66032,63966,38572,22984,247,1933,3,227,2066,0.583,0.055,0.104,5.5%,10.4%
0500000US22047,22047,22,47,"Iberville Parish, Louisiana",33387,664,32723,32497,15987,16338,61,101,2,8,226,0.531,0500000US22047,Iberville Parish,30241,1418,28823,28214,14632,13313,58,123,13,75,609,0.569,0.039,0.073,3.9%,7.3%
0500000US22049,22049,22,49,"Jackson Parish, Louisiana",16274,209,16065,15883,10989,4829,34,28,2,1,182,0.456,0500000US22049,Jackson Parish,15031,468,14563,14049,9896,3945,34,146,5,23,514,0.495,0.040,0.087,4.0%,8.7%
0500000US22051,22051,22,51,"Jefferson Parish, Louisiana",432552,53702,378850,373529,242268,112013,1629,16542,116,961,5321,0.602,0500000US22051,Jefferson Parish,440781,79057,361724,347614,208385,115900,1317,19528,105,2379,14110,0.672,0.070,0.116,7.0%,11.6%
0500000US22053,22053,22,53,"Jefferson Davis Parish, Louisiana",31594,538,31056,30524,24835,5450,146,62,3,28,532,0.352,0500000US22053,Jefferson Davis Parish,32250,734,31516,30354,24855,5130,147,100,4,118,1162,0.379,0.027,0.077,2.7%,7.7%
0500000US22055,22055,22,55,"Lafayette Parish, Louisiana",221578,8597,212981,210011,148972,56633,683,3293,57,373,2970,0.481,0500000US22055,Lafayette Parish,241753,15983,225770,218052,150475,60677,716,5212,68,904,7718,0.544,0.063,0.131,6.3%,13.1%
0500000US22057,22057,22,57,"Lafourche Parish, Louisiana",96318,3647,92671,91177,75080,12679,2623,707,26,62,1494,0.373,0500000US22057,Lafourche Parish,97557,5672,91885,88631,70722,14532,2427,759,31,160,3254,0.447,0.075,0.200,7.5%,20.0%
0500000US22059,22059,22,59,"La Salle Parish, Louisiana",14890,331,14559,14454,12520,1758,146,26,1,3,105,0.278,0500000US22059,LaSalle Parish,14791,1402,13389,12967,11263,1283,133,252,10,26,422,0.402,0.124,0.446,12.4%,44.6%
0500000US22061,22061,22,61,"Lincoln Parish, Louisiana",46735,1189,45546,45118,25313,18860,109,786,17,33,428,0.543,0500000US22061,Lincoln Parish,48396,1754,46642,45236,25672,18626,145,682,5,106,1406,0.568,0.025,0.047,2.5%,4.7%
0500000US22063,22063,22,63,"Livingston Parish, Louisiana",128026,3801,124225,123033,115362,6455,484,616,24,92,1192,0.185,0500000US22063,Livingston Parish,142282,8791,133491,127932,114876,11178,365,1116,36,361,5559,0.337,0.152,0.824,15.2%,82.4%
0500000US22065,22065,22,65,"Madison Parish, Louisiana",12093,188,11905,11810,4396,7357,23,26,0,8,95,0.497,0500000US22065,Madison Parish,10017,204,9813,9629,3414,6173,27,6,5,4,184,0.503,0.006,0.012,0.6%,1.2%
0500000US22067,22067,22,67,"Morehouse Parish, Louisiana",27979,255,27724,27484,14251,13078,36,98,12,9,240,0.522,0500000US22067,Morehouse Parish,25629,381,25248,24397,12220,11976,80,89,3,29,851,0.553,0.031,0.059,3.1%,5.9%
0500000US22069,22069,22,69,"Natchitoches Parish, Louisiana",39566,735,38831,38088,21109,16296,340,134,8,201,743,0.545,0500000US22069,Natchitoches Parish,37515,1490,36025,34525,18898,14857,284,166,19,301,1500,0.586,0.041,0.076,4.1%,7.6%
0500000US22071,22071,22,71,"Orleans Parish, Louisiana",343829,18051,325778,321418,104770,204866,827,9883,105,967,4360,0.548,0500000US22071,Orleans Parish,383997,31017,352980,340795,121385,205876,761,10573,125,2075,12185,0.604,0.056,0.102,5.6%,10.2%
0500000US22073,22073,22,73,"Ouachita Parish, Louisiana",153720,2760,150960,149430,91573,55946,347,1429,41,94,1530,0.512,0500000US22073,Ouachita Parish,160368,5658,154710,149357,87426,58804,413,2276,30,408,5353,0.566,0.054,0.105,5.4%,10.5%
0500000US22075,22075,22,75,"Plaquemines Parish, Louisiana",23042,1067,21975,21473,15617,4675,340,726,19,96,502,0.496,0500000US22075,Plaquemines Parish,23515,2236,21279,20155,13764,4863,255,1042,40,191,1124,0.601,0.106,0.213,10.6%,21.3%
0500000US22077,22077,22,77,"Pointe Coupee Parish, Louisiana",22802,492,22310,22109,13748,8247,16,57,0,41,201,0.505,0500000US22077,Pointe Coupee Parish,20758,625,20133,19622,12245,7221,37,60,2,57,511,0.529,0.024,0.048,2.4%,4.8%
0500000US22079,22079,22,79,"Rapides Parish, Louisiana",131613,3418,128195,126237,81623,41937,968,1545,26,138,1958,0.513,0500000US22079,Rapides Parish,130023,5090,124933,119782,76323,40261,901,1805,33,459,5151,0.556,0.043,0.085,4.3%,8.5%
0500000US22081,22081,22,81,"Red River Parish, Louisiana",9091,101,8990,8940,5305,3586,33,12,1,3,50,0.504,0500000US22081,Red River Parish,7620,188,7432,7163,4150,2952,41,0,0,20,269,0.551,0.048,0.095,4.8%,9.5%
0500000US22083,22083,22,83,"Richland Parish, Louisiana",20725,332,20393,20239,12714,7406,57,54,2,6,154,0.496,0500000US22083,Richland Parish,20043,400,19643,19139,11667,7303,53,50,0,66,504,0.527,0.032,0.064,3.2%,6.4%
0500000US22085,22085,22,85,"Sabine Parish, Louisiana",24233,820,23413,22715,16776,4009,1877,53,0,0,698,0.485,0500000US22085,Sabine Parish,22155,710,21445,20304,14850,3520,1790,63,12,69,1141,0.515,0.030,0.062,3.0%,6.2%
0500000US22087,22087,22,87,"St. Bernard Parish, Louisiana",35897,3309,32588,31893,24607,6272,201,678,10,125,695,0.490,0500000US22087,St. Bernard Parish,43764,6010,37754,36013,23165,11370,215,972,6,285,1741,0.631,0.141,0.288,14.1%,28.8%
0500000US22089,22089,22,89,"St. Charles Parish, Louisiana",52780,2648,50132,49520,34925,13925,160,435,18,57,612,0.490,0500000US22089,St. Charles Parish,52549,4141,48408,46694,32708,13024,215,555,20,172,1714,0.544,0.054,0.110,5.4%,11.0%
0500000US22091,22091,22,91,"St. Helena Parish, Louisiana",11203,99,11104,11027,4999,5964,34,9,0,21,77,0.517,0500000US22091,St. Helena Parish,10920,216,10704,10424,4494,5846,38,19,4,23,280,0.543,0.026,0.050,2.6%,5.0%
0500000US22093,22093,22,93,"St. James Parish, Louisiana",22102,256,21846,21711,10478,11145,43,29,3,13,135,0.521,0500000US22093,St. James Parish,20192,343,19849,19487,9917,9486,28,28,0,28,362,0.537,0.017,0.032,1.7%,3.2%
0500000US22095,22095,22,95,"St. John the Baptist Parish, Louisiana",45924,2175,43749,43279,18374,24405,116,312,21,51,470,0.555,0500000US22095,St. John the Baptist Parish,42477,3291,39186,37990,13348,24076,105,314,7,140,1196,0.573,0.018,0.032,1.8%,3.2%
0500000US22097,22097,22,97,"St. Landry Parish, Louisiana",83384,1321,82063,81119,46025,34295,263,314,4,218,944,0.526,0500000US22097,St. Landry Parish,82540,2178,80362,78264,43225,34218,153,374,12,282,2098,0.553,0.027,0.051,2.7%,5.1%
0500000US22099,22099,22,99,"St. Martin Parish, Louisiana",52160,1071,51089,50465,33831,15956,214,393,3,68,624,0.485,0500000US22099,St. Martin Parish,51767,1679,50088,48759,32919,15050,177,440,3,170,1329,0.509,0.024,0.050,2.4%,5.0%
0500000US22101,22101,22,101,"St. Mary Parish, Louisiana",54650,2920,51730,50877,31267,17648,933,935,11,83,853,0.565,0500000US22101,St. Mary Parish,49406,4524,44882,43034,26334,14950,911,647,13,179,1848,0.614,0.049,0.087,4.9%,8.7%
0500000US22103,22103,22,103,"St. Tammany Parish, Louisiana",233740,10970,222770,219371,188317,26430,1031,2914,73,606,3399,0.336,0500000US22103,St. Tammany Parish,264570,20844,243726,232260,192144,33969,876,3814,105,1352,11466,0.448,0.112,0.334,11.2%,33.4%
0500000US22105,22105,22,105,"Tangipahoa Parish, Louisiana",121097,4260,116837,115504,77807,36485,355,714,35,108,1333,0.495,0500000US22105,Tangipahoa Parish,133157,7242,125915,121345,79825,39770,409,942,23,376,4570,0.547,0.052,0.106,5.2%,10.6%
0500000US22107,22107,22,107,"Tensas Parish, Louisiana",5252,65,5187,5149,2178,2957,6,8,0,0,38,0.511,0500000US22107,Tensas Parish,4147,67,4080,3978,1728,2232,0,6,1,11,102,0.536,0.025,0.049,2.5%,4.9%
0500000US22109,22109,22,109,"Terrebonne Parish, Louisiana",111860,4421,107439,105321,76789,21046,6226,1127,40,93,2118,0.488,0500000US22109,Terrebonne Parish,109580,7358,102222,97301,68802,21059,5808,1294,39,299,4921,0.559,0.071,0.146,7.1%,14.6%
0500000US22111,22111,22,111,"Union Parish, Louisiana",22721,943,21778,21653,15398,6153,53,31,16,2,125,0.466,0500000US22111,Union Parish,21107,1135,19972,19402,14289,4980,59,38,6,30,570,0.482,0.017,0.036,1.7%,3.6%
0500000US22113,22113,22,113,"Vermilion Parish, Louisiana",57999,1381,56618,55951,46305,8246,195,1148,4,53,667,0.341,0500000US22113,Vermilion Parish,57359,2296,55063,53482,44020,7859,171,1253,9,170,1581,0.389,0.048,0.141,4.8%,14.1%
0500000US22115,22115,22,115,"Vernon Parish, Louisiana",52334,3775,48559,46943,37794,7280,684,881,242,62,1616,0.452,0500000US22115,Vernon Parish,48750,4175,44575,41833,33599,6325,484,862,289,274,2742,0.497,0.045,0.099,4.5%,9.9%
0500000US22117,22117,22,117,"Washington Parish, Louisiana",47168,887,46281,45826,31019,14561,121,108,3,14,455,0.472,0500000US22117,Washington Parish,45463,1410,44053,42721,29588,12758,134,161,0,80,1332,0.496,0.024,0.051,2.4%,5.1%
0500000US22119,22119,22,119,"Webster Parish, Louisiana",41207,670,40537,40105,26067,13756,138,116,8,20,432,0.488,0500000US22119,Webster Parish,36967,688,36279,35058,22554,12142,136,138,12,76,1221,0.518,0.030,0.062,3.0%,6.2%
0500000US22121,22121,22,121,"West Baton Rouge Parish, Louisiana",23788,544,23244,23010,13931,8953,27,72,1,26,234,0.515,0500000US22121,West Baton Rouge Parish,27199,1244,25955,25184,14114,10714,59,219,8,70,771,0.573,0.058,0.112,5.8%,11.2%
0500000US22123,22123,22,123,"West Carroll Parish, Louisiana",11604,299,11305,11217,9337,1810,44,26,0,0,88,0.327,0500000US22123,West Carroll Parish,9751,325,9426,9187,7799,1338,37,13,0,0,239,0.340,0.012,0.037,1.2%,3.7%
0500000US22125,22125,22,125,"West Feliciana Parish, Louisiana",15625,251,15374,15298,8002,7235,20,31,3,7,76,0.523,0500000US22125,West Feliciana Parish,15310,651,14659,14336,10585,3589,95,30,5,32,323,0.465,-0.058,-0.111,-5.8%,-11.1%
0500000US22127,22127,22,127,"Winn Parish, Louisiana",15313,240,15073,14918,10108,4666,96,39,2,7,155,0.471,0500000US22127,Winn Parish,13755,1023,12732,12306,8498,3518,77,172,16,25,426,0.546,0.075,0.160,7.5%,16.0%
0500000US23001,23001,23,1,"Androscoggin County, Maine",107702,1669,106033,104075,98931,3858,383,773,29,101,1958,0.154,0500000US23001,Androscoggin County,111139,2222,108917,104014,95875,6436,382,895,50,376,4903,0.250,0.096,0.620,9.6%,62.0%
0500000US23003,23003,23,3,"Aroostook County, Maine",71870,667,71203,70301,68341,430,1195,310,11,14,902,0.095,0500000US23003,Aroostook County,67105,912,66193,64333,62163,423,1206,392,18,131,1860,0.141,0.045,0.476,4.5%,47.6%
0500000US23005,23005,23,5,"Cumberland County, Maine",281674,5045,276629,271978,258468,6577,819,5705,80,329,4651,0.156,0500000US23005,Cumberland County,303069,8011,295058,283161,262137,11925,667,7167,96,1169,11897,0.248,0.091,0.582,9.1%,58.2%
0500000US23007,23007,23,7,"Franklin County, Maine",30768,315,30453,30068,29731,70,113,129,10,15,385,0.066,0500000US23007,Franklin County,29456,407,29049,27965,27211,166,73,383,23,109,1084,0.145,0.079,1.196,7.9%,119.6%
0500000US23009,23009,23,9,"Hancock County, Maine",54418,594,53824,53255,52353,206,199,445,6,46,569,0.074,0500000US23009,Hancock County,55478,969,54509,52469,51098,351,231,560,10,219,2040,0.150,0.076,1.021,7.6%,102.1%
0500000US23011,23011,23,11,"Kennebec County, Maine",122151,1504,120647,118773,116549,642,559,886,44,93,1874,0.089,0500000US23011,Kennebec County,123642,2552,121090,115621,112682,850,460,1215,29,385,5469,0.167,0.078,0.872,7.8%,87.2%
0500000US23013,23013,23,13,"Knox County, Maine",39736,337,39399,38877,38337,192,136,184,5,23,522,0.069,0500000US23013,Knox County,40607,672,39935,38340,37533,256,139,250,18,144,1595,0.144,0.075,1.087,7.5%,108.7%
0500000US23015,23015,23,15,"Lincoln County, Maine",34457,287,34170,33839,33437,96,107,185,0,14,331,0.058,0500000US23015,Lincoln County,35237,395,34842,33665,33071,156,105,227,9,97,1177,0.118,0.060,1.028,6.0%,102.8%
0500000US23017,23017,23,17,"Oxford County, Maine",57833,587,57246,56420,55584,202,203,355,14,62,826,0.076,0500000US23017,Oxford County,57777,865,56912,54300,53456,209,187,275,16,157,2612,0.142,0.066,0.867,6.6%,86.7%
0500000US23019,23019,23,19,"Penobscot County, Maine",153923,1620,152303,150125,145700,1117,1774,1405,41,88,2178,0.103,0500000US23019,Penobscot County,152199,2715,149484,143408,138306,1443,1349,1853,37,420,6076,0.172,0.069,0.663,6.9%,66.3%
0500000US23021,23021,23,21,"Piscataquis County, Maine",17535,169,17366,17182,16893,52,90,128,7,12,184,0.072,0500000US23021,Piscataquis County,16800,261,16539,15826,15474,57,102,120,7,66,713,0.149,0.078,1.088,7.8%,108.8%
0500000US23023,23023,23,23,"Sagadahoc County, Maine",35293,453,34840,34314,33663,237,115,258,5,36,526,0.090,0500000US23023,Sagadahoc County,36699,649,36050,34583,33830,295,92,247,3,116,1467,0.148,0.058,0.651,5.8%,65.1%
0500000US23025,23025,23,25,"Somerset County, Maine",52228,409,51819,51188,50437,185,232,294,11,29,631,0.067,0500000US23025,Somerset County,50477,656,49821,47790,46914,248,213,261,14,140,2031,0.134,0.067,1.001,6.7%,100.1%
0500000US23027,23027,23,27,"Waldo County, Maine",38786,349,38437,37922,37453,122,159,149,13,26,515,0.067,0500000US23027,Waldo County,39607,559,39048,37504,36883,135,140,200,12,134,1544,0.131,0.064,0.948,6.4%,94.8%
0500000US23029,23029,23,29,"Washington County, Maine",32856,452,32404,31891,29998,132,1586,148,5,22,513,0.164,0500000US23029,Washington County,31095,667,30428,29338,27587,156,1381,121,7,86,1090,0.209,0.046,0.279,4.6%,27.9%
0500000US23031,23031,23,31,"York County, Maine",197131,2478,194653,192222,188422,1036,540,2088,32,104,2431,0.086,0500000US23031,York County,211972,4097,207875,199860,194044,2009,566,2502,58,681,8015,0.160,0.074,0.861,7.4%,86.1%
0500000US24001,24001,24,1,"Allegany County, Maryland",75087,1085,74002,72895,66195,5959,90,566,26,59,1107,0.216,0500000US24001,Allegany County,68106,1149,66957,64294,57953,5286,115,733,22,185,2663,0.268,0.052,0.240,5.2%,24.0%
0500000US24003,24003,24,3,"Anne Arundel County, Maryland",537656,32902,504754,491996,389386,81819,1365,18154,392,880,12758,0.447,0500000US24003,Anne Arundel County,588261,56796,531465,500342,367893,102555,1178,25187,411,3118,31123,0.565,0.118,0.263,11.8%,26.3%
0500000US24005,24005,24,5,"Baltimore County, Maryland",805029,33735,771294,755141,504556,206913,2107,39865,255,1445,16153,0.536,0500000US24005,Baltimore County,854535,61492,793043,757343,443263,252724,1942,54701,252,4461,35700,0.632,0.096,0.179,9.6%,17.9%
0500000US24009,24009,24,9,"Calvert County, Maryland",88737,2437,86300,84166,70680,11816,280,1246,39,105,2134,0.346,0500000US24009,Calvert County,92783,4202,88581,82918,68760,11922,207,1549,74,406,5663,0.428,0.082,0.237,8.2%,23.7%
0500000US24011,24011,24,11,"Caroline County, Maryland",33066,1816,31250,30695,25853,4520,95,186,9,32,555,0.367,0500000US24011,Caroline County,33293,2820,30473,29009,24114,4368,67,345,13,102,1464,0.449,0.082,0.224,8.2%,22.4%
0500000US24013,24013,24,13,"Carroll County, Maryland",167134,4363,162771,160544,152428,5229,288,2402,47,150,2227,0.166,0500000US24013,Carroll County,172891,7745,165146,157733,146701,6361,268,3766,36,601,7413,0.274,0.108,0.651,10.8%,65.1%
0500000US24015,24015,24,15,"Cecil County, Maryland",101108,3407,97701,95885,88348,6080,246,1078,43,90,1816,0.231,0500000US24015,Cecil County,103725,5450,98275,92879,83485,7500,231,1232,23,408,5396,0.341,0.110,0.476,11.0%,47.6%
0500000US24017,24017,24,17,"Charles County, Maryland",146551,6259,140292,135609,70905,59201,877,4296,87,243,4683,0.599,0500000US24017,Charles County,166617,11677,154940,145405,56832,80850,995,5624,147,957,9535,0.639,0.040,0.066,4.0%,6.6%
0500000US24019,24019,24,19,"Dorchester County, Maryland",32618,1130,31488,30952,21581,8937,99,299,8,28,536,0.486,0500000US24019,Dorchester County,32531,1777,30754,29490,19891,9017,91,355,6,130,1264,0.545,0.059,0.122,5.9%,12.2%
0500000US24021,24021,24,21,"Frederick County, Maryland",233385,17135,216250,211141,181645,19611,512,8876,92,405,5109,0.380,0500000US24021,Frederick County,271717,32119,239598,226070,183636,27007,401,13427,154,1445,13528,0.514,0.135,0.354,13.5%,35.4%
0500000US24023,24023,24,23,"Garrett County, Maryland",30097,220,29877,29692,29278,299,37,76,0,2,185,0.053,0500000US24023,Garrett County,28806,321,28485,27812,27402,239,33,82,2,54,673,0.094,0.041,0.764,4.1%,76.4%
0500000US24025,24025,24,25,"Harford County, Maryland",244826,8613,236213,231063,194004,30334,500,5774,171,280,5150,0.354,0500000US24025,Harford County,260924,14007,246917,233746,186984,36837,442,8094,178,1211,13171,0.460,0.106,0.298,10.6%,29.8%
0500000US24027,24027,24,27,"Howard County, Maryland",287085,16729,270356,261585,169972,49150,511,41101,105,746,8771,0.595,0500000US24027,Howard County,332317,27362,304955,288115,155236,64018,461,66073,114,2213,16840,0.696,0.100,0.169,10.0%,16.9%
0500000US24029,24029,24,29,"Kent County, Maryland",20197,907,19290,18987,15783,3003,23,157,3,18,303,0.365,0500000US24029,Kent County,19198,1061,18137,17471,14384,2751,24,250,0,62,666,0.414,0.049,0.134,4.9%,13.4%
0500000US24031,24031,24,31,"Montgomery County, Maryland",971777,165398,806379,780755,478765,161689,1580,134677,427,3617,25624,0.681,0500000US24031,Montgomery County,1062061,217409,844652,796572,430980,192714,1377,162472,440,8589,48080,0.735,0.054,0.080,5.4%,8.0%
0500000US24033,24033,24,33,"Prince George's County, Maryland",863420,128972,734448,716760,128853,548439,2156,34815,330,2167,17688,0.550,0500000US24033,Prince George's County,967201,205463,761738,730330,109060,571866,1887,41436,335,5746,31408,0.590,0.040,0.072,4.0%,7.2%
0500000US24035,24035,24,35,"Queen Anne's County, Maryland",47798,1452,46346,45631,41733,3258,127,460,12,41,715,0.232,0500000US24035,Queen Anne's County,49874,2538,47336,45408,41782,2775,63,587,11,190,1928,0.291,0.059,0.255,5.9%,25.5%
0500000US24037,24037,24,37,"St. Mary's County, Maryland",105151,3972,101179,98307,80402,14831,339,2552,64,119,2872,0.393,0500000US24037,St. Mary's County,113777,6545,107232,100465,80233,15994,318,3301,86,533,6767,0.475,0.083,0.210,8.3%,21.0%
0500000US24039,24039,24,39,"Somerset County, Maryland",26470,863,25607,25192,13796,11082,83,183,2,46,415,0.552,0500000US24039,Somerset County,24620,1075,23545,22735,12886,9449,80,250,1,69,810,0.576,0.024,0.043,2.4%,4.3%
0500000US24041,24041,24,41,"Talbot County, Maryland",37782,2073,35709,35203,29829,4778,48,463,16,69,506,0.357,0500000US24041,Talbot County,37526,3352,34174,33005,28065,4186,45,536,11,162,1169,0.419,0.062,0.173,6.2%,17.3%
0500000US24043,24043,24,43,"Washington County, Maryland",147430,5104,142326,139132,122748,13836,244,2042,61,201,3194,0.296,0500000US24043,Washington County,154705,10289,144416,136594,115223,17241,253,3083,63,731,7822,0.425,0.129,0.437,12.9%,43.7%
0500000US24045,24045,24,45,"Wicomico County, Maryland",98733,4478,94255,92189,65767,23534,198,2460,21,209,2066,0.496,0500000US24045,Wicomico County,103588,7091,96497,91740,60340,27586,212,3120,39,443,4757,0.582,0.086,0.173,8.6%,17.3%
0500000US24047,24047,24,47,"Worcester County, Maryland",51454,1622,49832,49087,41331,6973,126,569,10,78,745,0.335,0500000US24047,Worcester County,52460,2078,50382,48546,41383,6166,87,739,5,166,1836,0.361,0.026,0.077,2.6%,7.7%
0500000US24510,24510,24,510,"Baltimore city, Maryland",620961,25960,595001,584473,174120,392938,1884,14397,192,942,10528,0.518,0500000US24510,Baltimore city,585708,45927,539781,518693,157296,335615,1278,21020,152,3332,21088,0.591,0.072,0.140,7.2%,14.0%
0500000US25001,25001,25,1,"Barnstable County, Massachusetts",215888,4687,211201,206980,197327,3857,1184,2263,65,2284,4221,0.163,0500000US25001,Barnstable County,228996,7908,221088,208758,194561,6409,1092,3183,65,3448,12330,0.273,0.110,0.672,11.0%,67.2%
0500000US25003,25003,25,3,"Berkshire County, Massachusetts",131219,4530,126689,124321,118926,3334,197,1602,23,239,2368,0.176,0500000US25003,Berkshire County,129026,7064,121962,116141,109263,4064,165,1999,18,632,5821,0.277,0.100,0.569,10.0%,56.9%
0500000US25005,25005,25,5,"Bristol County, Massachusetts",548285,33020,515265,503634,469344,15736,1089,10140,119,7206,11631,0.262,0500000US25005,Bristol County,579200,54751,524449,492202,445658,23123,938,13651,102,8730,32247,0.394,0.132,0.503,13.2%,50.3%
0500000US25007,25007,25,7,"Dukes County, Massachusetts",16535,384,16151,15625,14275,477,175,123,4,571,526,0.251,0500000US25007,Dukes County,20600,534,20066,18121,16230,795,202,184,9,701,1945,0.367,0.116,0.462,11.6%,46.2%
0500000US25009,25009,25,9,"Essex County, Massachusetts",743159,122745,620414,611093,565035,19566,915,22864,161,2552,9321,0.393,0500000US25009,Essex County,809829,182847,626982,600507,536424,27081,782,29302,130,6788,26475,0.507,0.114,0.290,11.4%,29.0%
0500000US25011,25011,25,11,"Franklin County, Massachusetts",71372,2250,69122,67851,65978,703,175,887,9,99,1271,0.144,0500000US25011,Franklin County,71029,3592,67437,64106,61464,963,121,1186,10,362,3331,0.246,0.102,0.709,10.2%,70.9%
0500000US25013,25013,25,13,"Hampden County, Massachusetts",463490,96776,366714,359894,313846,35692,717,8937,114,588,6820,0.491,0500000US25013,Hampden County,465825,121319,344506,329335,278464,35988,659,12110,169,1945,15171,0.567,0.076,0.154,7.6%,15.4%
0500000US25015,25015,25,15,"Hampshire County, Massachusetts",158080,7455,150625,147545,136249,3547,242,7123,41,343,3080,0.252,0500000US25015,Hampshire County,162308,11622,150686,143662,127578,4360,205,10740,56,723,7024,0.370,0.118,0.469,11.8%,46.9%
0500000US25017,25017,25,17,"Middlesex County, Massachusetts",1503085,98350,1404735,1373980,1150251,65733,1578,139325,331,16762,30755,0.399,0500000US25017,Middlesex County,1632002,143245,1488757,1406508,1085919,80996,1414,209632,353,28194,82249,0.528,0.129,0.323,12.9%,32.3%
0500000US25019,25019,25,19,"Nantucket County, Massachusetts",10172,957,9215,9060,8192,664,6,118,1,79,155,0.338,0500000US25019,Nantucket County,14255,2312,11943,11328,9889,1006,19,263,2,149,615,0.485,0.147,0.436,14.7%,43.6%
0500000US25021,25021,25,21,"Norfolk County, Massachusetts",670850,22004,648846,637747,538758,36329,811,57625,107,4117,11099,0.343,0500000US25021,Norfolk County,725981,38110,687871,658159,512421,49311,701,88240,142,7344,29712,0.478,0.135,0.392,13.5%,39.2%
0500000US25023,25023,25,23,"Plymouth County, Massachusetts",494919,15619,479300,468049,415341,33991,1024,5928,118,11647,11251,0.289,0500000US25023,Plymouth County,530819,23952,506867,470950,406919,43482,796,7693,94,11966,35917,0.398,0.110,0.379,11.0%,37.9%
0500000US25025,25025,25,25,"Suffolk County, Massachusetts",722023,143455,578568,561911,346979,142980,1367,58963,196,11426,16657,0.683,0500000US25025,Suffolk County,797936,178527,619409,581892,352900,135255,1147,80607,281,11702,37517,0.713,0.030,0.044,3.0%,4.4%
0500000US25027,25027,25,27,"Worcester County, Massachusetts",798552,75422,723130,710090,644299,29084,1298,31597,178,3634,13040,0.337,0500000US25027,Worcester County,862111,111902,750209,712285,611207,44222,1146,46110,176,9424,37924,0.473,0.136,0.404,13.6%,40.4%
0500000US26001,26001,26,1,"Alcona County, Michigan",10942,124,10818,10727,10621,13,62,25,1,5,91,0.058,0500000US26001,Alcona County,10167,122,10045,9715,9593,23,57,14,1,27,330,0.108,0.051,0.884,5.1%,88.4%
0500000US26003,26003,26,3,"Alger County, Michigan",9601,114,9487,9238,8213,607,387,31,0,0,249,0.262,0500000US26003,Alger County,8842,115,8727,8283,7323,585,327,22,1,25,444,0.306,0.044,0.167,4.4%,16.7%
0500000US26005,26005,26,5,"Allegan County, Michigan",111408,7454,103954,102461,99945,1264,543,620,21,68,1493,0.190,0500000US26005,Allegan County,120502,9389,111113,106387,103088,1446,561,839,20,433,4726,0.260,0.070,0.367,7.0%,36.7%
0500000US26007,26007,26,7,"Alpena County, Michigan",29598,304,29294,29011,28623,78,150,148,10,2,283,0.065,0500000US26007,Alpena County,28907,417,28490,27416,27006,99,120,112,12,67,1074,0.126,0.061,0.945,6.1%,94.5%
0500000US26009,26009,26,9,"Antrim County, Michigan",23580,404,23176,22871,22546,35,224,47,8,11,305,0.085,0500000US26009,Antrim County,23431,459,22972,22117,21743,39,192,70,18,55,855,0.137,0.052,0.609,5.2%,60.9%
0500000US26011,26011,26,11,"Arenac County, Michigan",15899,225,15674,15489,15231,29,183,29,9,8,185,0.082,0500000US26011,Arenac County,15002,270,14732,14144,13919,35,126,38,1,25,588,0.137,0.055,0.678,5.5%,67.8%
0500000US26013,26013,26,13,"Baraga County, Michigan",8860,86,8774,8389,6605,635,1130,13,0,6,385,0.421,0500000US26013,Baraga County,8158,102,8056,7474,5753,598,1083,15,3,22,582,0.474,0.054,0.127,5.4%,12.7%
0500000US26015,26015,26,15,"Barry County, Michigan",59173,1336,57837,57185,56487,205,251,212,5,25,652,0.088,0500000US26015,Barry County,62423,2142,60281,57753,56779,295,221,245,15,198,2528,0.170,0.082,0.928,8.2%,92.8%
0500000US26017,26017,26,17,"Bay County, Michigan",107771,5093,102678,100913,98241,1574,476,566,13,43,1765,0.166,0500000US26017,Bay County,103856,5930,97926,93563,90811,1598,359,538,0,257,4363,0.230,0.064,0.384,6.4%,38.4%
0500000US26019,26019,26,19,"Benzie County, Michigan",17525,302,17223,17020,16658,71,244,44,0,3,203,0.096,0500000US26019,Benzie County,17970,391,17579,16953,16597,56,164,71,0,65,626,0.145,0.049,0.515,4.9%,51.5%
0500000US26021,26021,26,21,"Berrien County, Michigan",156813,7054,149759,146597,119389,23766,765,2410,115,152,3162,0.395,0500000US26021,Berrien County,154316,9210,145106,137478,111603,21199,740,3159,109,668,7628,0.452,0.057,0.144,5.7%,14.4%
0500000US26023,26023,26,23,"Branch County, Michigan",45248,1804,43444,42882,41116,1380,166,196,2,22,562,0.172,0500000US26023,Branch County,44862,2583,42279,40692,39025,1124,132,266,10,135,1587,0.238,0.066,0.387,6.6%,38.7%
0500000US26025,26025,26,25,"Calhoun County, Michigan",136146,6177,129969,126349,108664,14630,714,2154,45,142,3620,0.348,0500000US26025,Calhoun County,134310,7426,126884,119640,100385,14275,683,3715,29,553,7244,0.423,0.075,0.215,7.5%,21.5%
0500000US26027,26027,26,27,"Cass County, Michigan",52293,1570,50723,49366,45704,2776,476,334,6,70,1357,0.232,0500000US26027,Cass County,51589,2161,49428,46647,43309,2272,521,316,11,218,2781,0.288,0.057,0.246,5.7%,24.6%
0500000US26029,26029,26,29,"Charlevoix County, Michigan",25949,359,25590,25158,24602,76,359,99,11,11,432,0.100,0500000US26029,Charlevoix County,26054,425,25629,24568,23881,74,367,122,10,114,1061,0.158,0.057,0.570,5.7%,57.0%
0500000US26031,26031,26,31,"Cheboygan County, Michigan",26152,211,25941,25299,24324,129,760,71,7,8,642,0.133,0500000US26031,Cheboygan County,25579,341,25238,23799,22872,89,687,85,1,65,1439,0.196,0.063,0.472,6.3%,47.2%
0500000US26033,26033,26,33,"Chippewa County, Michigan",38520,480,38040,36311,27542,2503,6007,228,21,10,1729,0.458,0500000US26033,Chippewa County,36785,757,36028,33048,24544,2611,5601,193,12,87,2980,0.520,0.062,0.134,6.2%,13.4%
0500000US26035,26035,26,35,"Clare County, Michigan",30926,464,30462,30056,29612,145,188,90,8,13,406,0.083,0500000US26035,Clare County,30856,621,30235,29109,28628,140,181,72,0,88,1126,0.137,0.055,0.661,5.5%,66.1%
0500000US26037,26037,26,37,"Clinton County, Michigan",75382,2947,72435,71242,68243,1506,309,1105,12,67,1193,0.178,0500000US26037,Clinton County,79128,3940,75188,71923,67915,1640,234,1870,23,241,3265,0.258,0.080,0.450,8.0%,45.0%
0500000US26039,26039,26,39,"Crawford County, Michigan",14074,182,13892,13754,13586,42,71,52,1,2,138,0.068,0500000US26039,Crawford County,12988,292,12696,12254,12026,57,83,55,4,29,442,0.141,0.073,1.077,7.3%,107.7%
0500000US26041,26041,26,41,"Delta County, Michigan",37069,318,36751,36008,34920,71,858,145,7,7,743,0.112,0500000US26041,Delta County,36903,543,36360,34595,33441,93,818,153,8,82,1765,0.176,0.064,0.576,6.4%,57.6%
0500000US26043,26043,26,43,"Dickinson County, Michigan",26168,270,25898,25623,25269,86,138,120,7,3,275,0.067,0500000US26043,Dickinson County,25947,440,25507,24570,24198,61,117,147,4,43,937,0.129,0.061,0.912,6.1%,91.2%
0500000US26045,26045,26,45,"Eaton County, Michigan",107759,5101,102658,100526,91540,6661,407,1790,13,115,2132,0.272,0500000US26045,Eaton County,109175,6527,102648,97773,87200,7463,307,2444,13,346,4875,0.351,0.080,0.293,8.0%,29.3%
0500000US26047,26047,26,47,"Emmet County, Michigan",32694,429,32265,31617,30132,152,1139,174,6,14,648,0.149,0500000US26047,Emmet County,34112,592,33520,31884,30359,159,1074,173,22,97,1636,0.204,0.056,0.373,5.6%,37.3%
0500000US26049,26049,26,49,"Genesee County, Michigan",425790,12983,412807,403294,309683,87352,1961,3834,74,390,9513,0.427,0500000US26049,Genesee County,406211,16259,389952,369501,283483,79080,1391,4041,116,1390,20451,0.471,0.043,0.102,4.3%,10.2%
0500000US26051,26051,26,51,"Gladwin County, Michigan",25692,310,25382,25160,24904,60,116,76,1,3,222,0.060,0500000US26051,Gladwin County,25386,482,24904,24110,23830,68,95,72,0,45,794,0.117,0.057,0.953,5.7%,95.3%
0500000US26053,26053,26,53,"Gogebic County, Michigan",16427,142,16285,16065,14965,676,383,37,1,3,220,0.168,0500000US26053,Gogebic County,14380,222,14158,13632,12981,65,512,35,3,36,526,0.182,0.015,0.087,1.5%,8.7%
0500000US26055,26055,26,55,"Grand Traverse County, Michigan",86986,1874,85112,83805,81188,1023,941,588,25,40,1307,0.128,0500000US26055,Grand Traverse County,95238,3010,92228,88147,85543,583,878,813,41,289,4081,0.190,0.062,0.487,6.2%,48.7%
0500000US26057,26057,26,57,"Gratiot County, Michigan",42476,2301,40175,39826,37144,2341,172,145,8,16,349,0.229,0500000US26057,Gratiot County,41761,3153,38608,37448,34812,2195,156,161,28,96,1160,0.296,0.067,0.291,6.7%,29.1%
0500000US26059,26059,26,59,"Hillsdale County, Michigan",46688,826,45862,45344,44765,206,162,185,3,23,518,0.080,0500000US26059,Hillsdale County,45746,1172,44574,42803,42145,196,143,176,6,137,1771,0.149,0.069,0.858,6.9%,85.8%
0500000US26061,26061,26,61,"Houghton County, Michigan",36628,415,36213,35760,34299,193,182,1050,16,20,453,0.122,0500000US26061,Houghton County,37361,669,36692,35320,33854,280,159,855,21,151,1372,0.177,0.055,0.448,5.5%,44.8%
0500000US26063,26063,26,63,"Huron County, Michigan",33118,657,32461,32208,31830,121,100,148,4,5,253,0.076,0500000US26063,Huron County,31407,840,30567,29859,29508,77,77,150,5,42,708,0.116,0.040,0.531,4.0%,53.1%
0500000US26065,26065,26,65,"Ingham County, Michigan",280895,20526,260369,251645,203459,31931,1239,14504,88,424,8724,0.453,0500000US26065,Ingham County,284900,24422,260478,244935,191551,34446,953,16424,110,1451,15543,0.520,0.066,0.146,6.6%,14.6%
0500000US26067,26067,26,67,"Ionia County, Michigan",63905,2791,61114,60428,56962,2962,230,241,6,27,686,0.201,0500000US26067,Ionia County,66804,3364,63440,61428,57617,3210,246,229,5,121,2012,0.250,0.049,0.244,4.9%,24.4%
0500000US26069,26069,26,69,"Iosco County, Michigan",25887,403,25484,25140,24710,121,161,125,12,11,344,0.088,0500000US26069,Iosco County,25237,610,24627,23744,23244,164,124,153,3,56,883,0.150,0.061,0.695,6.1%,69.5%
0500000US26071,26071,26,71,"Iron County, Michigan",11817,161,11656,11520,11370,14,97,32,2,5,136,0.074,0500000US26071,Iron County,11631,206,11425,11015,10823,24,93,41,0,34,410,0.132,0.059,0.794,5.9%,79.4%
0500000US26073,26073,26,73,"Isabella County, Michigan",70311,2197,68114,66513,61514,1643,2161,1141,14,40,1601,0.231,0500000US26073,Isabella County,64394,3006,61388,58386,52970,2076,2025,1116,17,182,3002,0.317,0.085,0.369,8.5%,36.9%
0500000US26075,26075,26,75,"Jackson County, Michigan",160248,4837,155411,151963,137588,12560,521,1122,27,145,3448,0.255,0500000US26075,Jackson County,160366,6184,154182,145975,131097,12385,515,1475,30,473,8207,0.322,0.066,0.260,6.6%,26.0%
0500000US26077,26077,26,77,"Kalamazoo County, Michigan",250331,9959,240372,233287,200047,26677,923,5186,73,381,7085,0.347,0500000US26077,Kalamazoo County,261670,14776,246894,232340,193428,29686,819,6983,57,1367,14554,0.434,0.086,0.249,8.6%,24.9%
0500000US26079,26079,26,79,"Kalkaska County, Michigan",17153,214,16939,16694,16456,50,144,41,1,2,245,0.079,0500000US26079,Kalkaska County,17939,355,17584,16821,16523,40,139,60,0,59,763,0.149,0.070,0.886,7.0%,88.6%
0500000US26081,26081,26,81,"Kent County, Michigan",602622,58437,544185,531058,457769,56372,2075,13932,163,747,13127,0.404,0500000US26081,Kent County,657974,75228,582746,553973,465491,62359,1818,21799,175,2331,28773,0.474,0.071,0.175,7.1%,17.5%
0500000US26083,26083,26,83,"Keweenaw County, Michigan",2156,15,2141,2124,2117,3,3,1,0,0,17,0.036,0500000US26083,Keweenaw County,2046,27,2019,1958,1948,4,1,0,0,5,61,0.092,0.057,1.586,5.7%,158.6%
0500000US26085,26085,26,85,"Lake County, Michigan",11539,243,11296,11028,9897,1034,78,16,1,2,268,0.255,0500000US26085,Lake County,12096,1195,10901,10297,9360,795,65,45,8,24,604,0.385,0.129,0.507,12.9%,50.7%
0500000US26087,26087,26,87,"Lapeer County, Michigan",88319,3622,84697,83728,82147,896,348,308,9,20,969,0.133,0500000US26087,Lapeer County,88619,4244,84375,80768,78871,966,277,396,8,250,3607,0.204,0.071,0.533,7.1%,53.3%
0500000US26089,26089,26,89,"Leelanau County, Michigan",21708,794,20914,20639,19799,56,682,92,2,8,275,0.166,0500000US26089,Leelanau County,22301,917,21384,20590,19781,64,577,106,4,58,794,0.210,0.044,0.265,4.4%,26.5%
0500000US26091,26091,26,91,"Lenawee County, Michigan",99892,7614,92278,90819,87483,2397,379,492,21,47,1459,0.226,0500000US26091,Lenawee County,99423,8494,90929,86688,83126,2437,342,476,8,299,4241,0.291,0.065,0.286,6.5%,28.6%
0500000US26093,26093,26,93,"Livingston County, Michigan",180967,3460,177507,175529,172513,776,648,1412,73,107,1978,0.091,0500000US26093,Livingston County,193866,5503,188363,180691,176756,1117,512,1626,113,567,7672,0.166,0.076,0.833,7.6%,83.3%
0500000US26095,26095,26,95,"Luce County, Michigan",6631,82,6549,6353,5275,735,325,17,1,0,196,0.351,0500000US26095,Luce County,5339,74,5265,4903,4514,12,365,2,0,10,362,0.276,-0.076,-0.216,-7.6%,-21.6%
0500000US26097,26097,26,97,"Mackinac County, Michigan",11113,126,10987,10415,8411,57,1909,22,1,15,572,0.395,0500000US26097,Mackinac County,10834,167,10667,9815,8015,56,1682,28,0,34,852,0.422,0.027,0.069,2.7%,6.9%
0500000US26099,26099,26,99,"Macomb County, Michigan",840978,19095,821883,805976,705693,72053,2351,24908,168,803,15907,0.287,0500000US26099,Macomb County,881217,26214,855003,816915,665241,108532,1766,38244,193,2939,38088,0.410,0.124,0.431,12.4%,43.1%
0500000US26101,26101,26,101,"Manistee County, Michigan",24733,634,24099,23698,22402,718,493,64,14,7,401,0.177,0500000US26101,Manistee County,25032,830,24202,23067,21836,606,487,79,2,57,1135,0.235,0.057,0.324,5.7%,32.4%
0500000US26103,26103,26,103,"Marquette County, Michigan",67077,767,66310,65096,62412,1126,1139,384,11,24,1214,0.133,0500000US26103,Marquette County,66017,1344,64673,61434,59038,790,1011,400,17,178,3239,0.197,0.064,0.479,6.4%,47.9%
0500000US26105,26105,26,105,"Mason County, Michigan",28705,1150,27555,27146,26595,156,254,130,0,11,409,0.140,0500000US26105,Mason County,29052,1290,27762,26573,25944,167,219,154,8,81,1189,0.199,0.059,0.423,5.9%,42.3%
0500000US26107,26107,26,107,"Mecosta County, Michigan",42798,731,42067,41245,39633,1055,240,277,7,33,822,0.141,0500000US26107,Mecosta County,39714,1026,38688,36927,35521,772,190,312,14,118,1761,0.197,0.056,0.396,5.6%,39.6%
0500000US26109,26109,26,109,"Menominee County, Michigan",24029,278,23751,23486,22715,68,619,70,8,6,265,0.105,0500000US26109,Menominee County,23502,486,23016,22282,21325,98,727,94,5,33,734,0.174,0.069,0.653,6.9%,65.3%
0500000US26111,26111,26,111,"Midland County, Michigan",83629,1704,81925,80823,77846,983,336,1555,46,57,1102,0.132,0500000US26111,Midland County,83494,2659,80835,77173,73825,942,293,1710,83,320,3662,0.215,0.082,0.621,8.2%,62.1%
0500000US26113,26113,26,113,"Missaukee County, Michigan",14849,306,14543,14389,14230,42,71,45,1,0,154,0.081,0500000US26113,Missaukee County,15052,499,14553,14088,13940,33,48,43,1,23,465,0.140,0.059,0.730,5.9%,73.0%
0500000US26115,26115,26,115,"Monroe County, Michigan",152021,4667,147354,145089,140609,3144,397,837,24,78,2265,0.143,0500000US26115,Monroe County,154809,6231,148578,141285,135369,4036,414,952,24,490,7293,0.231,0.088,0.615,8.8%,61.5%
0500000US26117,26117,26,117,"Montcalm County, Michigan",63342,1932,61410,60635,58635,1476,269,220,15,20,775,0.141,0500000US26117,Montcalm County,66614,2697,63917,61594,58880,2118,212,225,23,136,2323,0.215,0.073,0.519,7.3%,51.9%
0500000US26119,26119,26,119,"Montmorency County, Michigan",9765,96,9669,9536,9465,15,41,14,1,0,133,0.060,0500000US26119,Montmorency County,9153,125,9028,8689,8551,12,68,24,0,34,339,0.126,0.065,1.086,6.5%,108.6%
0500000US26121,26121,26,121,"Muskegon County, Michigan",172188,8261,163927,160030,133132,24599,1240,919,18,122,3897,0.379,0500000US26121,Muskegon County,175824,10283,165541,156510,130141,23622,1106,1073,31,537,9031,0.428,0.049,0.129,4.9%,12.9%
0500000US26123,26123,26,123,"Newaygo County, Michigan",48460,2663,45797,45151,44119,474,331,184,11,32,646,0.168,0500000US26123,Newaygo County,49978,2969,47009,44924,43915,424,256,189,14,126,2085,0.223,0.055,0.326,5.5%,32.6%
0500000US26125,26125,26,125,"Oakland County, Michigan",1202362,41920,1160442,1137801,903398,162303,2872,67577,212,1439,22641,0.413,0500000US26125,Oakland County,1274395,60838,1213557,1161369,879137,168797,2236,105665,304,5230,52188,0.496,0.083,0.202,8.3%,20.2%
0500000US26127,26127,26,127,"Oceana County, Michigan",26570,3629,22941,22623,22227,100,212,60,4,20,318,0.281,0500000US26127,Oceana County,26659,4108,22551,21661,21191,123,195,69,4,79,890,0.343,0.062,0.220,6.2%,22.0%
0500000US26129,26129,26,129,"Ogemaw County, Michigan",21699,309,21390,21139,20865,37,147,76,6,8,251,0.075,0500000US26129,Ogemaw County,20770,437,20333,19558,19268,59,108,57,8,58,775,0.138,0.063,0.834,6.3%,83.4%
0500000US26131,26131,26,131,"Ontonagon County, Michigan",6780,64,6716,6637,6546,6,70,11,1,3,79,0.068,0500000US26131,Ontonagon County,5816,68,5748,5534,5434,8,60,20,2,10,214,0.125,0.058,0.858,5.8%,85.8%
0500000US26133,26133,26,133,"Osceola County, Michigan",23528,344,23184,22833,22531,125,119,48,5,5,351,0.082,0500000US26133,Osceola County,22891,400,22491,21586,21188,155,142,34,6,61,905,0.141,0.059,0.713,5.9%,71.3%
0500000US26135,26135,26,135,"Oscoda County, Michigan",8640,79,8561,8452,8380,14,46,7,3,2,109,0.059,0500000US26135,Oscoda County,8219,154,8065,7742,7684,8,34,5,0,11,323,0.124,0.065,1.102,6.5%,110.2%
0500000US26137,26137,26,137,"Otsego County, Michigan",24164,299,23865,23521,23186,78,151,92,11,3,344,0.079,0500000US26137,Otsego County,25091,446,24645,23558,23156,100,151,91,0,60,1087,0.146,0.067,0.851,6.7%,85.1%
0500000US26139,26139,26,139,"Ottawa County, Michigan",263801,22761,241040,237323,226156,3551,806,6576,64,170,3717,0.257,0500000US26139,Ottawa County,296200,29382,266818,256158,241520,5071,726,7895,95,851,10660,0.323,0.066,0.259,6.6%,25.9%
0500000US26141,26141,26,141,"Presque Isle County, Michigan",13376,116,13260,13149,12972,56,79,40,1,1,111,0.059,0500000US26141,Presque Isle County,12982,154,12828,12455,12282,28,67,52,0,26,373,0.104,0.045,0.753,4.5%,75.3%
0500000US26143,26143,26,143,"Roscommon County, Michigan",24449,275,24174,23894,23592,89,136,72,2,3,280,0.069,0500000US26143,Roscommon County,23459,434,23025,22170,21883,60,94,76,10,47,855,0.128,0.060,0.869,6.0%,86.9%
0500000US26145,26145,26,145,"Saginaw County, Michigan",200169,15573,184596,181364,141187,37222,660,2067,55,173,3232,0.461,0500000US26145,Saginaw County,190124,16904,173220,165959,128722,33548,462,2373,85,769,7261,0.501,0.039,0.085,3.9%,8.5%
0500000US26147,26147,26,147,"St. Clair County, Michigan",163040,4708,158332,155609,150213,3860,647,763,27,99,2723,0.149,0500000US26147,St. Clair County,160383,5505,154878,147995,142396,3773,561,809,13,443,6883,0.208,0.059,0.392,5.9%,39.2%
0500000US26149,26149,26,149,"St. Joseph County, Michigan",61295,4034,57261,56184,53930,1555,234,416,2,47,1077,0.221,0500000US26149,St. Joseph County,60939,5427,55512,52763,50674,1341,151,414,9,174,2749,0.298,0.077,0.351,7.7%,35.1%
0500000US26151,26151,26,151,"Sanilac County, Michigan",43114,1439,41675,41302,40852,142,157,125,7,19,373,0.101,0500000US26151,Sanilac County,40611,1674,38937,37656,37209,151,112,84,2,98,1281,0.158,0.057,0.563,5.7%,56.3%
0500000US26153,26153,26,153,"Schoolcraft County, Michigan",8485,64,8421,8157,7394,11,735,13,0,4,264,0.232,0500000US26153,Schoolcraft County,8047,96,7951,7457,6727,10,699,15,1,5,494,0.290,0.058,0.248,5.8%,24.8%
0500000US26155,26155,26,155,"Shiawassee County, Michigan",70648,1695,68953,68153,67240,305,303,247,22,36,800,0.093,0500000US26155,Shiawassee County,68094,2024,66070,63276,62239,319,223,288,19,188,2794,0.162,0.069,0.734,6.9%,73.4%
0500000US26157,26157,26,157,"Tuscola County, Michigan",55729,1571,54158,53604,52547,621,233,155,15,33,554,0.110,0500000US26157,Tuscola County,53323,1808,51515,49486,48611,402,174,155,12,132,2029,0.166,0.056,0.513,5.6%,51.3%
0500000US26159,26159,26,159,"Van Buren County, Michigan",76258,7758,68500,66943,63028,3007,530,300,15,63,1557,0.304,0500000US26159,Van Buren County,75587,8966,66621,62996,59400,2348,552,384,27,285,3625,0.365,0.061,0.199,6.1%,19.9%
0500000US26161,26161,26,161,"Washtenaw County, Michigan",344791,13860,330931,320772,248675,43152,976,27005,118,846,10159,0.456,0500000US26161,Washtenaw County,372258,20731,351527,330811,252220,42125,715,33517,183,2051,20716,0.514,0.058,0.128,5.8%,12.8%
0500000US26163,26163,26,163,"Wayne County, Michigan",1820584,95260,1725324,1688897,902180,732801,5635,45590,304,2387,36427,0.589,0500000US26163,Wayne County,1793561,117649,1675912,1603574,857132,669277,4265,64604,322,7974,72338,0.625,0.036,0.062,3.6%,6.2%
0500000US26165,26165,26,165,"Wexford County, Michigan",32735,519,32216,31792,31246,122,189,193,18,24,424,0.088,0500000US26165,Wexford County,33673,790,32883,31432,30783,187,163,186,1,112,1451,0.162,0.073,0.830,7.3%,83.0%
0500000US27001,27001,27,1,"Aitkin County, Minnesota",16202,151,16051,15863,15398,53,376,27,4,5,188,0.096,0500000US27001,Aitkin County,15697,220,15477,14977,14479,58,376,38,1,25,500,0.147,0.051,0.535,5.1%,53.5%
0500000US27003,27003,27,3,"Anoka County, Minnesota",330844,12020,318824,311470,281929,14282,1994,12796,91,378,7354,0.269,0500000US27003,Anoka County,363887,19506,344381,327147,276205,28378,1912,19158,93,1401,17234,0.410,0.141,0.526,14.1%,52.6%
0500000US27005,27005,27,5,"Becker County, Minnesota",32504,398,32106,31187,28539,128,2372,124,7,17,919,0.223,0500000US27005,Becker County,35183,575,34608,32527,29645,200,2417,156,9,100,2081,0.281,0.059,0.264,5.9%,26.4%
0500000US27007,27007,27,7,"Beltrami County, Minnesota",44442,676,43766,42477,33066,251,8821,304,18,17,1289,0.406,0500000US27007,Beltrami County,46228,1108,45120,42579,32445,519,9198,268,15,134,2541,0.464,0.058,0.143,5.8%,14.3%
0500000US27009,27009,27,9,"Benton County, Minnesota",38451,632,37819,37262,35939,738,146,420,4,15,557,0.125,0500000US27009,Benton County,41379,1216,40163,38576,35821,1991,184,463,8,109,1587,0.246,0.120,0.960,12.0%,96.0%
0500000US27011,27011,27,11,"Big Stone County, Minnesota",5269,41,5228,5191,5150,10,22,4,0,5,37,0.045,0500000US27011,Big Stone County,5166,140,5026,4912,4809,19,34,12,4,34,114,0.132,0.088,1.967,8.8%,196.7%
0500000US27013,27013,27,13,"Blue Earth County, Minnesota",64013,1586,62427,61565,58394,1717,142,1247,21,44,862,0.166,0500000US27013,Blue Earth County,69112,3221,65891,63408,57222,3873,208,1834,24,247,2483,0.307,0.141,0.851,14.1%,85.1%
0500000US27015,27015,27,15,"Brown County, Minnesota",25893,860,25033,24891,24662,56,19,152,2,0,142,0.092,0500000US27015,Brown County,25912,1171,24741,24277,23968,118,39,126,6,20,464,0.142,0.050,0.549,5.0%,54.9%
0500000US27017,27017,27,17,"Carlton County, Minnesota",35386,484,34902,34135,31458,494,2012,160,2,9,767,0.206,0500000US27017,Carlton County,36207,612,35595,33864,30910,556,2148,153,12,85,1731,0.265,0.059,0.288,5.9%,28.8%
0500000US27019,27019,27,19,"Carver County, Minnesota",91042,3515,87527,86324,82536,1068,186,2456,9,69,1203,0.176,0500000US27019,Carver County,106922,5308,101614,97725,91443,2173,193,3617,15,284,3889,0.263,0.088,0.499,8.8%,49.9%
0500000US27021,27021,27,21,"Cass County, Minnesota",28567,340,28227,27637,24383,59,3092,88,3,12,590,0.259,0500000US27021,Cass County,30066,426,29640,28370,24675,64,3424,111,0,96,1270,0.311,0.052,0.202,5.2%,20.2%
0500000US27023,27023,27,23,"Chippewa County, Minnesota",12441,611,11830,11707,11370,65,116,57,97,2,123,0.162,0500000US27023,Chippewa County,12598,1243,11355,11039,10473,75,102,44,296,49,316,0.298,0.136,0.838,13.6%,83.8%
0500000US27025,27025,27,25,"Chisago County, Minnesota",53887,835,53052,52461,51013,636,313,471,9,19,591,0.103,0500000US27025,Chisago County,56621,1451,55170,52914,50804,845,309,768,3,185,2256,0.192,0.089,0.862,8.9%,86.2%
0500000US27027,27027,27,27,"Clay County, Minnesota",58999,2056,56943,55894,53434,825,744,836,17,38,1049,0.178,0500000US27027,Clay County,65318,3011,62307,59511,54424,3141,1032,764,16,134,2796,0.299,0.121,0.683,12.1%,68.3%
0500000US27029,27029,27,29,"Clearwater County, Minnesota",8695,120,8575,8342,7537,30,752,21,1,1,233,0.240,0500000US27029,Clearwater County,8524,101,8423,7969,7151,19,752,23,2,22,454,0.285,0.045,0.188,4.5%,18.8%
0500000US27031,27031,27,31,"Cook County, Minnesota",5176,58,5118,5011,4528,15,437,27,3,1,107,0.227,0500000US27031,Cook County,5600,123,5477,5219,4670,25,450,48,1,25,258,0.295,0.068,0.301,6.8%,30.1%
0500000US27033,27033,27,33,"Cottonwood County, Minnesota",11687,720,10967,10862,10432,82,23,302,17,6,105,0.199,0500000US27033,Cottonwood County,11517,1115,10402,10072,9418,135,25,361,80,53,330,0.320,0.121,0.610,12.1%,61.0%
0500000US27035,27035,27,35,"Crow Wing County, Minnesota",62500,652,61848,61022,59979,297,471,232,15,28,826,0.079,0500000US27035,Crow Wing County,66123,912,65211,62849,61252,383,623,332,19,240,2362,0.140,0.062,0.783,6.2%,78.3%
0500000US27037,27037,27,37,"Dakota County, Minnesota",398552,23966,374586,365732,327962,18235,1339,17350,199,647,8854,0.315,0500000US27037,Dakota County,439882,36305,403577,383570,323629,32191,1490,23932,184,2144,20007,0.441,0.127,0.403,12.7%,40.3%
0500000US27039,27039,27,39,"Dodge County, Minnesota",20087,915,19172,18980,18780,59,38,90,4,9,192,0.124,0500000US27039,Dodge County,20867,1057,19810,19140,18807,126,37,104,1,65,670,0.184,0.060,0.488,6.0%,48.8%
0500000US27041,27041,27,41,"Douglas County, Minnesota",36009,341,35668,35387,34974,146,94,163,3,7,281,0.056,0500000US27041,Douglas County,39006,815,38191,37254,36629,223,104,227,11,60,937,0.117,0.061,1.073,6.1%,107.3%
0500000US27043,27043,27,43,"Faribault County, Minnesota",14553,817,13736,13647,13519,43,41,43,0,1,89,0.134,0500000US27043,Faribault County,13921,1013,12908,12599,12402,55,58,45,0,39,309,0.200,0.067,0.498,6.7%,49.8%
0500000US27045,27045,27,45,"Fillmore County, Minnesota",20866,207,20659,20517,20375,48,20,71,0,3,142,0.046,0500000US27045,Fillmore County,21228,341,20887,20416,20173,98,7,71,2,65,471,0.096,0.050,1.074,5.0%,107.4%
0500000US27047,27047,27,47,"Freeborn County, Minnesota",31255,2750,28505,28215,27701,200,55,232,10,17,290,0.207,0500000US27047,Freeborn County,30895,3183,27712,26826,25071,460,76,1135,5,79,886,0.328,0.122,0.590,12.2%,59.0%
0500000US27049,27049,27,49,"Goodhue County, Minnesota",46183,1342,44841,44238,43027,429,474,271,17,20,603,0.131,0500000US27049,Goodhue County,47582,1797,45785,44253,42516,661,540,348,33,155,1532,0.199,0.068,0.520,6.8%,52.0%
0500000US27051,27051,27,51,"Grant County, Minnesota",6018,94,5924,5871,5832,19,4,14,0,2,53,0.061,0500000US27051,Grant County,6074,135,5939,5764,5699,13,27,14,7,4,175,0.118,0.058,0.955,5.8%,95.5%
0500000US27053,27053,27,53,"Hennepin County, Minnesota",1152425,77676,1074749,1044045,826670,134240,8848,71535,431,2321,30704,0.463,0500000US27053,Hennepin County,1281565,98250,1183315,1122327,840845,169603,8016,97348,388,6127,60988,0.538,0.075,0.163,7.5%,16.3%
0500000US27055,27055,27,55,"Houston County, Minnesota",19027,132,18895,18704,18482,98,31,86,2,5,191,0.056,0500000US27055,Houston County,18843,243,18600,18108,17840,90,42,101,4,31,492,0.103,0.046,0.826,4.6%,82.6%
0500000US27057,27057,27,57,"Hubbard County, Minnesota",20428,327,20101,19759,19122,47,525,49,1,15,342,0.123,0500000US27057,Hubbard County,21344,489,20855,19915,19139,82,560,66,12,56,940,0.193,0.070,0.573,7.0%,57.3%
0500000US27059,27059,27,59,"Isanti County, Minnesota",37816,582,37234,36683,35958,228,163,302,12,20,551,0.095,0500000US27059,Isanti County,41135,896,40239,38729,37559,314,201,488,13,154,1510,0.164,0.069,0.724,6.9%,72.4%
0500000US27061,27061,27,61,"Itasca County, Minnesota",45058,417,44641,43793,41951,136,1541,142,12,11,848,0.132,0500000US27061,Itasca County,45014,618,44396,42109,40166,174,1497,145,2,125,2287,0.200,0.068,0.520,6.8%,52.0%
0500000US27063,27063,27,63,"Jackson County, Minnesota",10266,277,9989,9904,9701,47,15,136,0,5,85,0.106,0500000US27063,Jackson County,9989,401,9588,9313,9026,120,22,122,0,23,275,0.181,0.075,0.705,7.5%,70.5%
0500000US27065,27065,27,65,"Kanabec County, Minnesota",16239,214,16025,15801,15606,52,84,53,3,3,224,0.076,0500000US27065,Kanabec County,16032,238,15794,15227,14954,65,113,80,0,15,567,0.128,0.052,0.689,5.2%,68.9%
0500000US27067,27067,27,67,"Kandiyohi County, Minnesota",42239,4710,37529,37233,35964,952,107,167,16,27,296,0.262,0500000US27067,Kandiyohi County,43732,5916,37816,36757,33303,2618,115,586,37,98,1059,0.397,0.135,0.517,13.5%,51.7%
0500000US27069,27069,27,69,"Kittson County, Minnesota",4552,69,4483,4463,4434,11,4,14,0,0,20,0.051,0500000US27069,Kittson County,4207,83,4124,4027,3974,1,15,17,6,14,97,0.107,0.056,1.097,5.6%,109.7%
0500000US27071,27071,27,71,"Koochiching County, Minnesota",13311,147,13164,12940,12512,76,303,44,1,4,224,0.115,0500000US27071,Koochiching County,12062,167,11895,11318,10920,44,278,34,12,30,577,0.177,0.062,0.536,6.2%,53.6%
0500000US27073,27073,27,73,"Lac qui Parle County, Minnesota",7259,108,7151,7099,7040,17,10,29,2,1,52,0.059,0500000US27073,Lac qui Parle County,6719,202,6517,6342,6244,32,10,40,0,16,175,0.135,0.076,1.279,7.6%,127.9%
0500000US27075,27075,27,75,"Lake County, Minnesota",10866,80,10786,10657,10558,16,50,31,0,2,129,0.056,0500000US27075,Lake County,10905,113,10792,10427,10281,11,50,55,0,30,365,0.110,0.054,0.974,5.4%,97.4%
0500000US27077,27077,27,77,"Lake of the Woods County, Minnesota",4045,35,4010,3937,3863,13,27,32,0,2,73,0.087,0500000US27077,Lake of the Woods County,3763,56,3707,3558,3497,12,19,17,0,13,149,0.135,0.047,0.538,4.7%,53.8%
0500000US27079,27079,27,79,"Le Sueur County, Minnesota",27703,1444,26259,26032,25691,88,72,159,5,17,227,0.137,0500000US27079,Le Sueur County,28674,1872,26802,26004,25463,262,67,134,20,58,798,0.206,0.069,0.504,6.9%,50.4%
0500000US27081,27081,27,81,"Lincoln County, Minnesota",5896,72,5824,5787,5749,8,8,14,0,8,37,0.049,0500000US27081,Lincoln County,5640,107,5533,5414,5368,10,11,22,0,3,119,0.093,0.044,0.902,4.4%,90.2%
0500000US27083,27083,27,83,"Lyon County, Minnesota",25857,1541,24316,24002,22637,575,82,677,6,25,314,0.229,0500000US27083,Lyon County,25269,1744,23525,22832,20535,906,84,1263,3,41,693,0.330,0.102,0.444,10.2%,44.4%
0500000US27085,27085,27,85,"McLeod County, Minnesota",36651,1811,34840,34561,34005,184,81,265,16,10,279,0.137,0500000US27085,McLeod County,36771,2555,34216,33208,32559,226,102,230,27,64,1008,0.210,0.074,0.540,7.4%,54.0%
0500000US27087,27087,27,87,"Mahnomen County, Minnesota",5413,99,5314,4861,2698,11,2148,3,1,0,453,0.587,0500000US27087,Mahnomen County,5411,154,5257,4566,2278,8,2256,7,0,17,691,0.632,0.045,0.077,4.5%,7.7%
0500000US27089,27089,27,89,"Marshall County, Minnesota",9439,337,9102,9039,8952,25,43,18,0,1,63,0.099,0500000US27089,Marshall County,9040,390,8650,8414,8332,12,29,19,0,22,236,0.148,0.049,0.492,4.9%,49.2%
0500000US27091,27091,27,91,"Martin County, Minnesota",20840,744,20096,19994,19766,62,54,103,5,4,102,0.099,0500000US27091,Martin County,20025,1320,18705,18235,17947,112,32,92,6,46,470,0.192,0.093,0.936,9.3%,93.6%
0500000US27093,27093,27,93,"Meeker County, Minnesota",23300,767,22533,22410,22233,68,33,59,9,8,123,0.088,0500000US27093,Meeker County,23400,950,22450,21858,21618,93,37,59,2,49,592,0.144,0.056,0.632,5.6%,63.2%
0500000US27095,27095,27,95,"Mille Lacs County, Minnesota",26097,377,25720,25304,23582,96,1534,79,2,11,416,0.180,0500000US27095,Mille Lacs County,26459,481,25978,24903,23131,78,1466,124,6,98,1075,0.231,0.051,0.285,5.1%,28.5%
0500000US27097,27097,27,97,"Morrison County, Minnesota",33198,402,32796,32475,32174,122,61,101,9,8,321,0.060,0500000US27097,Morrison County,34010,633,33377,32486,32032,179,111,102,5,57,891,0.112,0.051,0.850,5.1%,85.0%
0500000US27099,27099,27,99,"Mower County, Minnesota",39163,4138,35025,34530,32975,791,62,636,36,30,495,0.279,0500000US27099,Mower County,40029,5081,34948,33904,29804,1613,57,2052,255,123,1044,0.425,0.145,0.521,14.5%,52.1%
0500000US27101,27101,27,101,"Murray County, Minnesota",8725,242,8483,8435,8326,20,11,78,0,0,48,0.088,0500000US27101,Murray County,8179,382,7797,7633,7483,26,9,105,3,7,164,0.160,0.072,0.810,7.2%,81.0%
0500000US27103,27103,27,103,"Nicollet County, Minnesota",32727,1226,31501,31121,29944,658,74,429,1,15,380,0.161,0500000US27103,Nicollet County,34454,1800,32654,31739,29287,1672,141,558,10,71,915,0.271,0.111,0.688,11.1%,68.8%
0500000US27105,27105,27,105,"Nobles County, Minnesota",21378,4820,16558,16335,14365,727,67,1144,7,25,223,0.494,0500000US27105,Nobles County,22290,7271,15019,14603,12147,978,66,1329,41,42,416,0.591,0.097,0.197,9.7%,19.7%
0500000US27107,27107,27,107,"Norman County, Minnesota",6852,276,6576,6433,6293,11,100,25,0,4,143,0.154,0500000US27107,Norman County,6441,288,6153,5884,5702,17,115,18,0,32,269,0.212,0.058,0.376,5.8%,37.6%
0500000US27109,27109,27,109,"Olmsted County, Minnesota",144248,6081,138167,135470,120348,6751,297,7771,57,246,2697,0.297,0500000US27109,Olmsted County,162847,9196,153651,146901,124758,10959,380,10190,66,548,6750,0.400,0.103,0.347,10.3%,34.7%
0500000US27111,27111,27,111,"Otter Tail County, Minnesota",57303,1490,55813,55233,54244,422,261,264,29,13,580,0.103,0500000US27111,Otter Tail County,60081,2216,57865,55989,54362,843,284,334,17,149,1876,0.179,0.076,0.734,7.6%,73.4%
0500000US27113,27113,27,113,"Pennington County, Minnesota",13930,380,13550,13334,12867,181,193,86,1,6,216,0.145,0500000US27113,Pennington County,13992,671,13321,12759,12241,177,166,121,6,48,562,0.230,0.085,0.584,8.5%,58.4%
0500000US27115,27115,27,115,"Pine County, Minnesota",29750,723,29027,28531,26924,576,890,129,8,4,496,0.179,0500000US27115,Pine County,28876,713,28163,26918,25119,470,966,264,1,98,1245,0.239,0.061,0.339,6.1%,33.9%
0500000US27117,27117,27,117,"Pipestone County, Minnesota",9596,355,9241,9102,8880,52,96,69,0,5,139,0.142,0500000US27117,Pipestone County,9424,804,8620,8349,8057,107,100,66,0,19,271,0.261,0.119,0.837,11.9%,83.7%
0500000US27119,27119,27,119,"Polk County, Minnesota",31600,1720,29880,29379,28497,248,413,210,2,9,501,0.183,0500000US27119,Polk County,31192,1999,29193,28103,26538,958,376,156,4,71,1090,0.270,0.086,0.472,8.6%,47.2%
0500000US27121,27121,27,121,"Pope County, Minnesota",10995,95,10900,10818,10720,35,22,39,2,0,82,0.049,0500000US27121,Pope County,11308,191,11117,10882,10751,34,27,50,0,20,235,0.095,0.046,0.936,4.6%,93.6%
0500000US27123,27123,27,123,"Ramsey County, Minnesota",508640,36483,472157,458137,340194,54835,3143,59033,195,737,14020,0.522,0500000US27123,Ramsey County,552352,45034,507318,481820,320477,70101,2914,85775,214,2339,25498,0.614,0.093,0.178,9.3%,17.8%
0500000US27125,27125,27,125,"Red Lake County, Minnesota",4089,101,3988,3939,3876,7,52,4,0,0,49,0.101,0500000US27125,Red Lake County,3935,103,3832,3719,3625,15,57,5,3,14,113,0.150,0.049,0.488,4.9%,48.8%
0500000US27127,27127,27,127,"Redwood County, Minnesota",16059,335,15724,15443,14119,71,744,504,2,3,281,0.223,0500000US27127,Redwood County,15425,496,14929,14404,13123,76,774,414,1,16,525,0.271,0.048,0.213,4.8%,21.3%
0500000US27129,27129,27,129,"Renville County, Minnesota",15730,1046,14684,14534,14351,40,76,54,4,9,150,0.163,0500000US27129,Renville County,14723,1319,13404,13022,12766,60,103,61,5,27,382,0.239,0.076,0.468,7.6%,46.8%
0500000US27131,27131,27,131,"Rice County, Minnesota",64142,5122,59020,58218,54566,2021,247,1289,38,57,802,0.268,0500000US27131,Rice County,67097,6783,60314,58162,51523,4353,297,1554,10,425,2152,0.394,0.126,0.469,12.6%,46.9%
0500000US27133,27133,27,133,"Rock County, Minnesota",9687,197,9490,9386,9239,58,31,53,1,4,104,0.090,0500000US27133,Rock County,9704,364,9340,9056,8886,50,48,62,10,0,284,0.159,0.069,0.773,6.9%,77.3%
0500000US27135,27135,27,135,"Roseau County, Minnesota",15629,116,15513,15323,14696,37,199,385,3,3,190,0.115,0500000US27135,Roseau County,15331,238,15093,14478,13700,85,229,398,10,56,615,0.199,0.084,0.730,8.4%,73.0%
0500000US27137,27137,27,137,"St. Louis County, Minnesota",200226,2409,197817,193649,184769,2688,4277,1760,60,95,4168,0.147,0500000US27137,St. Louis County,200231,3603,196628,187030,176112,4075,4305,1901,58,579,9598,0.223,0.076,0.514,7.6%,51.4%
0500000US27139,27139,27,139,"Scott County, Minnesota",129928,5771,124157,121723,109816,3298,969,7303,94,243,2434,0.279,0500000US27139,Scott County,150928,9008,141920,135783,115630,8137,1406,9939,64,607,6137,0.400,0.121,0.433,12.1%,43.3%
0500000US27141,27141,27,141,"Sherburne County, Minnesota",88499,1941,86558,85222,81983,1644,389,1126,18,62,1336,0.141,0500000US27141,Sherburne County,97183,2820,94363,90411,84761,3648,390,1277,22,313,3952,0.235,0.095,0.673,9.5%,67.3%
0500000US27143,27143,27,143,"Sibley County, Minnesota",15226,1098,14128,13990,13835,41,22,80,2,10,138,0.169,0500000US27143,Sibley County,14836,1315,13521,13160,12942,81,30,72,10,25,361,0.231,0.061,0.364,6.1%,36.4%
0500000US27145,27145,27,145,"Stearns County, Minnesota",150642,4190,146452,144495,136414,4595,392,2949,38,107,1957,0.178,0500000US27145,Stearns County,158292,6951,151341,146594,129276,13224,439,3159,61,435,4747,0.323,0.145,0.816,14.5%,81.6%
0500000US27147,27147,27,147,"Steele County, Minnesota",36576,2282,34294,33917,32544,1003,66,278,8,18,377,0.204,0500000US27147,Steele County,37406,3140,34266,33206,31376,1359,65,330,18,58,1060,0.287,0.084,0.411,8.4%,41.1%
0500000US27149,27149,27,149,"Stevens County, Minnesota",9726,337,9389,9237,8931,75,81,146,1,3,152,0.155,0500000US27149,Stevens County,9671,986,8685,8396,8093,84,110,68,1,40,289,0.288,0.133,0.859,13.3%,85.9%
0500000US27151,27151,27,151,"Swift County, Minnesota",9783,350,9433,9373,9271,48,30,21,3,0,60,0.101,0500000US27151,Swift County,9838,662,9176,8939,8618,79,26,78,133,5,237,0.227,0.127,1.259,12.7%,125.9%
0500000US27153,27153,27,153,"Todd County, Minnesota",24895,1288,23607,23348,23052,73,71,102,38,12,259,0.140,0500000US27153,Todd County,25262,2208,23054,22522,22117,95,76,97,72,65,532,0.225,0.086,0.612,8.6%,61.2%
0500000US27155,27155,27,155,"Traverse County, Minnesota",3558,50,3508,3471,3324,12,129,4,1,1,37,0.126,0500000US27155,Traverse County,3360,197,3163,3060,2851,21,183,0,0,5,103,0.273,0.147,1.171,14.7%,117.1%
0500000US27157,27157,27,157,"Wabasha County, Minnesota",21676,592,21084,20922,20712,80,29,93,1,7,162,0.086,0500000US27157,Wabasha County,21387,708,20679,20197,19921,121,32,97,6,20,482,0.131,0.045,0.518,4.5%,51.8%
0500000US27159,27159,27,159,"Wadena County, Minnesota",13843,176,13667,13472,13262,109,64,36,0,1,195,0.082,0500000US27159,Wadena County,14065,273,13792,13317,13044,118,73,54,9,19,475,0.138,0.057,0.692,5.7%,69.2%
0500000US27161,27161,27,161,"Waseca County, Minnesota",19136,985,18151,17947,17308,371,129,127,4,8,204,0.179,0500000US27161,Waseca County,18968,1271,17697,17132,16538,336,114,111,12,21,565,0.234,0.055,0.310,5.5%,31.0%
0500000US27163,27163,27,163,"Washington County, Minnesota",238136,8127,230009,225769,204111,8376,973,12023,72,214,4240,0.260,0500000US27163,Washington County,267568,13094,254474,242646,208277,13799,999,18530,72,969,11828,0.382,0.122,0.470,12.2%,47.0%
0500000US27165,27165,27,165,"Watonwan County, Minnesota",11211,2338,8873,8820,8632,74,22,86,2,4,53,0.364,0500000US27165,Watonwan County,11253,3227,8026,7845,7689,42,13,86,0,15,181,0.451,0.087,0.239,8.7%,23.9%
0500000US27167,27167,27,167,"Wilkin County, Minnesota",6576,130,6446,6384,6294,13,59,18,0,0,62,0.083,0500000US27167,Wilkin County,6506,211,6295,6060,5918,41,87,8,1,5,235,0.170,0.087,1.040,8.7%,104.0%
0500000US27169,27169,27,169,"Winona County, Minnesota",51461,1244,50217,49712,47828,642,116,1097,2,27,505,0.135,0500000US27169,Winona County,49671,1889,47782,46211,44178,892,84,933,0,124,1571,0.206,0.071,0.526,7.1%,52.6%
0500000US27171,27171,27,171,"Wright County, Minnesota",124700,3052,121648,120047,116786,1286,397,1459,42,77,1601,0.122,0500000US27171,Wright County,141337,4697,136640,131387,126031,2605,331,1877,35,508,5253,0.202,0.080,0.656,8.0%,65.6%
0500000US27173,27173,27,173,"Yellow Medicine County, Minnesota",10438,397,10041,9937,9581,15,301,30,2,8,104,0.155,0500000US27173,Yellow Medicine County,9528,448,9080,8765,8408,48,276,28,1,4,315,0.217,0.062,0.400,6.2%,40.0%
0500000US28001,28001,28,1,"Adams County, Mississippi",32297,2150,30147,29863,12485,17150,76,126,3,23,284,0.564,0500000US28001,Adams County,29538,1012,28526,27898,10926,16709,56,165,7,35,628,0.542,-0.023,-0.040,-2.3%,-4.0%
0500000US28003,28003,28,3,"Alcorn County, Mississippi",37057,1010,36047,35733,31313,4209,62,116,5,28,314,0.272,0500000US28003,Alcorn County,34740,1248,33492,32364,27738,4316,61,180,19,50,1128,0.345,0.072,0.266,7.2%,26.6%
0500000US28005,28005,28,5,"Amite County, Mississippi",13131,110,13021,12951,7516,5396,22,12,1,4,70,0.503,0500000US28005,Amite County,12720,129,12591,12343,7434,4835,25,31,0,18,248,0.513,0.010,0.020,1.0%,2.0%
0500000US28007,28007,28,7,"Attala County, Mississippi",19564,323,19241,19144,10866,8180,35,53,4,6,97,0.516,0500000US28007,Attala County,17889,331,17558,17219,9410,7642,29,97,4,37,339,0.540,0.024,0.046,2.4%,4.6%
0500000US28009,28009,28,9,"Benton County, Mississippi",8729,148,8581,8515,5229,3244,25,6,1,10,66,0.503,0500000US28009,Benton County,7646,145,7501,7264,4565,2654,6,1,0,38,237,0.522,0.019,0.038,1.9%,3.8%
0500000US28011,28011,28,11,"Bolivar County, Mississippi",34145,639,33506,33329,11241,21839,38,186,10,15,177,0.482,0500000US28011,Bolivar County,30985,794,30191,29539,9946,19257,22,262,0,52,652,0.510,0.027,0.057,2.7%,5.7%
0500000US28013,28013,28,13,"Calhoun County, Mississippi",14962,805,14157,14014,9851,4128,17,15,2,1,143,0.487,0500000US28013,Calhoun County,13266,747,12519,12156,8662,3444,15,17,0,18,363,0.502,0.015,0.031,1.5%,3.1%
0500000US28015,28015,28,15,"Carroll County, Mississippi",10597,106,10491,10408,6927,3444,15,19,0,3,83,0.467,0500000US28015,Carroll County,9998,154,9844,9621,6529,3030,15,29,0,18,223,0.481,0.014,0.030,1.4%,3.0%
0500000US28017,28017,28,17,"Chickasaw County, Mississippi",17392,643,16749,16619,9254,7292,22,43,1,7,130,0.540,0500000US28017,Chickasaw County,17106,642,16464,16060,8584,7407,13,41,0,15,404,0.559,0.019,0.035,1.9%,3.5%
0500000US28019,28019,28,19,"Choctaw County, Mississippi",8547,76,8471,8395,5803,2571,10,8,1,2,76,0.448,0500000US28019,Choctaw County,8246,117,8129,7919,5559,2332,15,6,0,7,210,0.465,0.016,0.036,1.6%,3.6%
0500000US28021,28021,28,21,"Claiborne County, Mississippi",9604,74,9530,9480,1353,8072,9,40,0,6,50,0.274,0500000US28021,Claiborne County,9135,72,9063,8949,974,7959,8,0,0,8,114,0.229,-0.044,-0.162,-4.4%,-16.2%
0500000US28023,28023,28,23,"Clarke County, Mississippi",16732,132,16600,16518,10674,5749,59,29,1,6,82,0.475,0500000US28023,Clarke County,15615,132,15483,15107,9950,5103,16,8,6,24,376,0.487,0.012,0.025,1.2%,2.5%
0500000US28025,28025,28,25,"Clay County, Mississippi",20634,199,20435,20341,8276,11977,27,45,2,14,94,0.502,0500000US28025,Clay County,18636,186,18450,18111,7196,10785,35,57,1,37,339,0.516,0.013,0.027,1.3%,2.7%
0500000US28027,28027,28,27,"Coahoma County, Mississippi",26151,293,25858,25761,5918,19698,20,114,4,7,97,0.381,0500000US28027,Coahoma County,21390,350,21040,20676,4285,16209,26,112,0,44,364,0.385,0.004,0.010,0.4%,1.0%
0500000US28029,28029,28,29,"Copiah County, Mississippi",29449,773,28676,28481,13399,14924,51,89,3,15,195,0.535,0500000US28029,Copiah County,28368,1111,27257,26640,12171,14264,17,121,24,43,617,0.561,0.026,0.048,2.6%,4.8%
0500000US28031,28031,28,31,"Covington County, Mississippi",19568,369,19199,19070,12202,6798,20,42,4,4,129,0.490,0500000US28031,Covington County,18340,418,17922,17573,11047,6384,20,83,4,35,349,0.515,0.025,0.051,2.5%,5.1%
0500000US28033,28033,28,33,"DeSoto County, Mississippi",161252,8086,153166,151252,113553,35124,343,2011,76,145,1914,0.454,0500000US28033,DeSoto County,185314,10161,175153,168528,108466,55972,298,3023,137,632,6625,0.562,0.108,0.237,10.8%,23.7%
0500000US28035,28035,28,35,"Forrest County, Mississippi",74934,2637,72297,71475,43766,26956,152,494,33,74,822,0.528,0500000US28035,Forrest County,78158,3258,74900,72578,43121,28151,177,789,29,311,2322,0.563,0.035,0.066,3.5%,6.6%
0500000US28037,28037,28,37,"Franklin County, Mississippi",8118,47,8071,8026,5230,2776,14,5,0,1,45,0.468,0500000US28037,Franklin County,7675,60,7615,7495,4910,2563,2,8,0,12,120,0.479,0.011,0.023,1.1%,2.3%
0500000US28039,28039,28,39,"George County, Mississippi",22578,453,22125,21955,20009,1821,66,47,0,12,170,0.208,0500000US28039,George County,24350,672,23678,22907,20929,1774,85,77,1,41,771,0.254,0.047,0.224,4.7%,22.4%
0500000US28041,28041,28,41,"Greene County, Mississippi",14400,133,14267,14160,10363,3735,40,19,1,2,107,0.415,0500000US28041,Greene County,13530,171,13359,13047,9809,3143,60,21,3,11,312,0.420,0.005,0.012,0.5%,1.2%
0500000US28043,28043,28,43,"Grenada County, Mississippi",21906,197,21709,21555,12350,9106,33,60,0,6,154,0.509,0500000US28043,Grenada County,21629,310,21319,20751,11258,9352,29,84,2,26,568,0.541,0.032,0.063,3.2%,6.3%
0500000US28045,28045,28,45,"Hancock County, Mississippi",43929,1446,42483,41676,37914,3075,193,416,20,58,807,0.249,0500000US28045,Hancock County,46053,1918,44135,42095,37341,3911,244,424,9,166,2040,0.332,0.083,0.333,8.3%,33.3%
0500000US28047,28047,28,47,"Harrison County, Mississippi",187105,9937,177168,173134,125741,40975,719,5258,227,214,4034,0.496,0500000US28047,Harrison County,208621,13976,194645,183930,125092,51143,786,5913,257,739,10715,0.572,0.076,0.153,7.6%,15.3%
0500000US28049,28049,28,49,"Hinds County, Mississippi",245285,3630,241655,239822,68609,168839,343,1851,29,151,1833,0.448,0500000US28049,Hinds County,227742,4564,223178,218589,58012,157483,332,2157,43,562,4589,0.456,0.008,0.019,0.8%,1.9%
0500000US28051,28051,28,51,"Holmes County, Mississippi",19198,134,19064,18973,2993,15925,18,30,1,6,91,0.288,0500000US28051,Holmes County,17000,112,16888,16623,2359,14194,36,20,0,14,265,0.283,-0.004,-0.015,-0.4%,-1.5%
0500000US28053,28053,28,53,"Humphreys County, Mississippi",9375,202,9173,9113,2133,6949,10,20,0,1,60,0.398,0500000US28053,Humphreys County,7785,91,7694,7526,1423,6072,13,10,0,8,168,0.358,-0.041,-0.102,-4.1%,-10.2%
0500000US28055,28055,28,55,"Issaquena County, Mississippi",1406,8,1398,1396,482,905,3,6,0,0,2,0.468,0500000US28055,Issaquena County,1338,128,1210,1195,440,748,1,5,0,1,15,0.570,0.102,0.218,10.2%,21.8%
0500000US28057,28057,28,57,"Itawamba County, Mississippi",23401,300,23101,22986,21490,1386,44,52,3,11,115,0.153,0500000US28057,Itawamba County,23863,384,23479,22890,21129,1623,51,50,0,37,589,0.211,0.058,0.376,5.8%,37.6%
0500000US28059,28059,28,59,"Jackson County, Mississippi",139668,6378,133290,131146,97670,29768,523,2991,68,126,2144,0.463,0500000US28059,Jackson County,143252,10050,133202,126829,92881,29713,572,3173,91,399,6373,0.529,0.066,0.144,6.6%,14.4%
0500000US28061,28061,28,61,"Jasper County, Mississippi",17062,136,16926,16833,7855,8944,14,16,0,4,93,0.513,0500000US28061,Jasper County,16367,169,16198,15920,7541,8324,28,8,0,19,278,0.529,0.015,0.030,1.5%,3.0%
0500000US28063,28063,28,63,"Jefferson County, Mississippi",7726,28,7698,7675,1056,6601,13,2,1,2,23,0.251,0500000US28063,Jefferson County,7260,74,7186,7063,891,6138,10,14,5,5,123,0.270,0.018,0.073,1.8%,7.3%
0500000US28065,28065,28,65,"Jefferson Davis County, Mississippi",12487,101,12386,12318,4802,7461,32,18,2,3,68,0.495,0500000US28065,Jefferson Davis County,11321,101,11220,10997,4330,6622,8,21,0,16,223,0.511,0.016,0.033,1.6%,3.3%
0500000US28067,28067,28,67,"Jones County, Mississippi",67761,3199,64562,64130,44432,19076,288,302,7,25,432,0.488,0500000US28067,Jones County,67246,4139,63107,61619,41676,19135,364,272,24,148,1488,0.531,0.042,0.086,4.2%,8.6%
0500000US28069,28069,28,69,"Kemper County, Mississippi",10456,52,10404,10334,3665,6273,385,10,0,1,70,0.516,0500000US28069,Kemper County,8988,67,8921,8778,2812,5486,460,6,1,13,143,0.527,0.011,0.021,1.1%,2.1%
0500000US28071,28071,28,71,"Lafayette County, Mississippi",47351,1073,46278,45842,33538,11155,87,1003,16,43,436,0.442,0500000US28071,Lafayette County,55813,2142,53671,51973,38766,11300,68,1685,24,130,1698,0.473,0.031,0.071,3.1%,7.1%
0500000US28073,28073,28,73,"Lamar County, Mississippi",55658,1205,54453,53946,42296,10834,109,655,19,33,507,0.384,0500000US28073,Lamar County,64222,2362,61860,59616,43865,14296,108,1091,50,206,2244,0.481,0.097,0.253,9.7%,25.3%
0500000US28075,28075,28,75,"Lauderdale County, Mississippi",80261,1448,78813,78262,43312,34158,140,569,17,66,551,0.527,0500000US28075,Lauderdale County,72984,1789,71195,69431,36534,31980,101,571,28,217,1764,0.556,0.029,0.055,2.9%,5.5%
0500000US28077,28077,28,77,"Lawrence County, Mississippi",12929,274,12655,12582,8567,3961,17,33,0,4,73,0.467,0500000US28077,Lawrence County,12016,207,11809,11562,7807,3690,17,33,4,11,247,0.483,0.016,0.035,1.6%,3.5%
0500000US28079,28079,28,79,"Leake County, Mississippi",23805,1020,22785,22634,11611,9620,1352,49,0,2,151,0.594,0500000US28079,Leake County,21275,1230,20045,19680,10069,8189,1297,78,5,42,365,0.620,0.027,0.045,2.7%,4.5%
0500000US28081,28081,28,81,"Lee County, Mississippi",82910,1991,80919,80037,56854,22498,120,513,19,33,882,0.455,0500000US28081,Lee County,83343,2828,80515,78205,52854,24131,94,920,25,181,2310,0.512,0.057,0.124,5.7%,12.4%
0500000US28083,28083,28,83,"Leflore County, Mississippi",32317,743,31574,31411,7930,23246,39,183,2,11,163,0.422,0500000US28083,Leflore County,28339,840,27499,27018,5963,20809,15,205,0,26,481,0.415,-0.006,-0.015,-0.6%,-1.5%
0500000US28085,28085,28,85,"Lincoln County, Mississippi",34869,330,34539,34306,23702,10400,63,117,8,16,233,0.449,0500000US28085,Lincoln County,34907,406,34501,33791,22996,10484,63,163,8,77,710,0.475,0.026,0.059,2.6%,5.9%
0500000US28087,28087,28,87,"Lowndes County, Mississippi",59779,914,58865,58308,31847,25904,98,394,31,34,557,0.528,0500000US28087,Lowndes County,58879,1323,57556,55998,29363,25885,110,514,16,110,1558,0.557,0.029,0.054,2.9%,5.4%
0500000US28089,28089,28,89,"Madison County, Mississippi",95203,2806,92397,91755,53287,36227,124,2029,18,70,642,0.541,0500000US28089,Madison County,109145,4117,105028,102439,60273,38526,160,3167,13,300,2589,0.568,0.027,0.050,2.7%,5.0%
0500000US28091,28091,28,91,"Marion County, Mississippi",27088,336,26752,26535,17661,8729,42,84,9,10,217,0.471,0500000US28091,Marion County,24441,406,24035,23457,15721,7583,42,65,0,46,578,0.489,0.018,0.039,1.8%,3.9%
0500000US28093,28093,28,93,"Marshall County, Mississippi",37144,1192,35952,35701,18161,17369,67,74,6,24,251,0.541,0500000US28093,Marshall County,33752,1540,32212,31380,16284,14880,55,74,20,67,832,0.570,0.029,0.054,2.9%,5.4%
0500000US28095,28095,28,95,"Monroe County, Mississippi",36989,355,36634,36373,24847,11381,57,71,4,13,261,0.454,0500000US28095,Monroe County,34180,473,33707,32962,22487,10311,50,67,3,44,745,0.475,0.022,0.047,2.2%,4.7%
0500000US28097,28097,28,97,"Montgomery County, Mississippi",10925,97,10828,10778,5769,4948,16,39,1,5,50,0.516,0500000US28097,Montgomery County,9822,106,9716,9499,5094,4364,9,24,0,8,217,0.533,0.017,0.033,1.7%,3.3%
0500000US28099,28099,28,99,"Neshoba County, Mississippi",29676,469,29207,28825,17797,6169,4745,102,6,6,382,0.571,0500000US28099,Neshoba County,29087,434,28653,27909,16426,6380,4913,122,0,68,744,0.604,0.032,0.057,3.2%,5.7%
0500000US28101,28101,28,101,"Newton County, Mississippi",21720,287,21433,21267,13599,6536,1072,51,0,9,166,0.515,0500000US28101,Newton County,21291,329,20962,20518,12796,6447,1169,77,0,29,444,0.543,0.029,0.056,2.9%,5.6%
0500000US28103,28103,28,103,"Noxubee County, Mississippi",11545,92,11453,11406,3113,8249,20,22,1,1,47,0.417,0500000US28103,Noxubee County,10285,172,10113,9860,2639,7190,13,14,0,4,253,0.445,0.028,0.067,2.8%,6.7%
0500000US28105,28105,28,105,"Oktibbeha County, Mississippi",47671,683,46988,46473,27825,17356,83,1151,12,46,515,0.526,0500000US28105,Oktibbeha County,51788,1268,50520,49292,29224,18228,93,1506,10,231,1228,0.556,0.030,0.057,3.0%,5.7%
0500000US28107,28107,28,107,"Panola County, Mississippi",34707,494,34213,33927,16981,16801,70,61,0,14,286,0.526,0500000US28107,Panola County,33208,678,32530,31830,15642,16035,52,62,4,35,700,0.544,0.018,0.034,1.8%,3.4%
0500000US28109,28109,28,109,"Pearl River County, Mississippi",55834,1636,54198,53346,45911,6853,281,222,31,48,852,0.308,0500000US28109,Pearl River County,56145,2284,53861,51463,44101,6666,256,275,0,165,2398,0.365,0.058,0.188,5.8%,18.8%
0500000US28111,28111,28,111,"Perry County, Mississippi",12250,119,12131,12021,9514,2449,32,14,0,12,110,0.357,0500000US28111,Perry County,11511,154,11357,11055,8868,2097,45,29,3,13,302,0.372,0.016,0.044,1.6%,4.4%
0500000US28113,28113,28,113,"Pike County, Mississippi",40404,489,39915,39654,18564,20740,111,229,2,8,261,0.525,0500000US28113,Pike County,40324,627,39697,38709,16769,21457,113,254,7,109,988,0.543,0.018,0.034,1.8%,3.4%
0500000US28115,28115,28,115,"Pontotoc County, Mississippi",29957,1849,28108,27766,23531,4096,47,56,7,29,342,0.360,0500000US28115,Pontotoc County,31184,2048,29136,28250,23859,4208,56,55,5,67,886,0.391,0.031,0.086,3.1%,8.6%
0500000US28117,28117,28,117,"Prentiss County, Mississippi",25276,307,24969,24735,21172,3481,29,33,2,18,234,0.279,0500000US28117,Prentiss County,25008,405,24603,23912,20166,3547,62,85,5,47,691,0.329,0.049,0.177,4.9%,17.7%
0500000US28119,28119,28,119,"Quitman County, Mississippi",8223,55,8168,8109,2369,5709,18,11,1,1,59,0.435,0500000US28119,Quitman County,6176,21,6155,6050,1484,4546,1,12,3,4,105,0.400,-0.035,-0.080,-3.5%,-8.0%
0500000US28121,28121,28,121,"Rankin County, Mississippi",141617,3795,137822,136588,108086,26519,227,1574,91,91,1234,0.381,0500000US28121,Rankin County,157031,5067,151964,147476,111990,32430,255,2260,94,447,4488,0.447,0.065,0.171,6.5%,17.1%
0500000US28123,28123,28,123,"Scott County, Mississippi",28264,3013,25251,25015,14353,10502,66,50,30,14,236,0.593,0500000US28123,Scott County,27990,4148,23842,23318,13145,9923,95,103,0,52,524,0.631,0.039,0.065,3.9%,6.5%
0500000US28125,28125,28,125,"Sharkey County, Mississippi",4916,39,4877,4856,1366,3475,3,11,0,1,21,0.423,0500000US28125,Sharkey County,3800,61,3739,3651,962,2671,0,14,3,1,88,0.441,0.018,0.043,1.8%,4.3%
0500000US28127,28127,28,127,"Simpson County, Mississippi",27503,387,27116,26918,17131,9624,35,78,34,16,198,0.489,0500000US28127,Simpson County,25949,386,25563,24915,15928,8803,36,84,2,62,648,0.507,0.018,0.037,1.8%,3.7%
0500000US28129,28129,28,129,"Smith County, Mississippi",16491,198,16293,16214,12421,3758,18,13,2,2,79,0.381,0500000US28129,Smith County,14209,198,14011,13754,10582,3111,20,19,0,22,257,0.397,0.016,0.043,1.6%,4.3%
0500000US28131,28131,28,131,"Stone County, Mississippi",17786,239,17547,17376,13820,3395,86,57,5,13,171,0.360,0500000US28131,Stone County,18333,444,17889,17310,13822,3239,79,89,9,72,579,0.399,0.039,0.109,3.9%,10.9%
0500000US28133,28133,28,133,"Sunflower County, Mississippi",29450,404,29046,28919,7410,21362,47,82,10,8,127,0.410,0500000US28133,Sunflower County,25971,661,25310,24946,6729,18077,19,84,0,37,364,0.448,0.037,0.091,3.7%,9.1%
0500000US28135,28135,28,135,"Tallahatchie County, Mississippi",15378,866,14512,14391,5580,8634,32,116,11,18,121,0.550,0500000US28135,Tallahatchie County,12715,425,12290,12134,4727,7390,4,10,3,0,156,0.523,-0.027,-0.049,-2.7%,-4.9%
0500000US28137,28137,28,137,"Tate County, Mississippi",28886,639,28247,27961,19091,8723,62,65,2,18,286,0.471,0500000US28137,Tate County,28064,805,27259,26447,18019,8231,52,63,1,81,812,0.500,0.029,0.061,2.9%,6.1%
0500000US28139,28139,28,139,"Tippah County, Mississippi",22232,985,21247,20996,17404,3509,34,34,1,14,251,0.360,0500000US28139,Tippah County,21815,1118,20697,20150,16609,3447,20,24,0,50,547,0.392,0.032,0.089,3.2%,8.9%
0500000US28141,28141,28,141,"Tishomingo County, Mississippi",19593,553,19040,18897,18326,516,32,21,1,1,143,0.124,0500000US28141,Tishomingo County,18850,537,18313,17699,17169,433,48,41,0,8,614,0.168,0.044,0.359,4.4%,35.9%
0500000US28143,28143,28,143,"Tunica County, Mississippi",10778,245,10533,10461,2486,7894,14,60,5,2,72,0.410,0500000US28143,Tunica County,9782,191,9591,9465,1853,7516,13,27,0,56,126,0.373,-0.037,-0.089,-3.7%,-8.9%
0500000US28145,28145,28,145,"Union County, Mississippi",27134,1210,25924,25656,21649,3911,29,46,5,16,268,0.341,0500000US28145,Union County,27777,1301,26476,25722,21560,3950,27,109,0,76,754,0.374,0.034,0.099,3.4%,9.9%
0500000US28147,28147,28,147,"Walthall County, Mississippi",15443,238,15205,15069,8145,6837,49,24,3,11,136,0.525,0500000US28147,Walthall County,13884,203,13681,13401,7547,5706,42,48,8,50,280,0.535,0.009,0.018,0.9%,1.8%
0500000US28149,28149,28,149,"Warren County, Mississippi",48773,896,47877,47522,24143,22836,106,412,10,15,355,0.535,0500000US28149,Warren County,44722,876,43846,42729,20909,21290,67,364,0,99,1117,0.554,0.018,0.034,1.8%,3.4%
0500000US28151,28151,28,151,"Washington County, Mississippi",51137,529,50608,50368,13654,36348,56,291,6,13,240,0.423,0500000US28151,Washington County,44922,584,44338,43523,11180,31919,48,302,5,69,815,0.433,0.009,0.022,0.9%,2.2%
0500000US28153,28153,28,153,"Wayne County, Mississippi",20747,246,20501,20355,12243,8035,38,34,2,3,146,0.502,0500000US28153,Wayne County,19779,343,19436,19100,11313,7708,31,35,2,11,336,0.520,0.019,0.037,1.9%,3.7%
0500000US28155,28155,28,155,"Webster County, Mississippi",10253,104,10149,10075,8007,2036,15,11,0,6,74,0.351,0500000US28155,Webster County,9926,155,9771,9522,7691,1782,14,13,1,21,249,0.367,0.016,0.046,1.6%,4.6%
0500000US28157,28157,28,157,"Wilkinson County, Mississippi",9878,41,9837,9806,2820,6969,12,1,0,4,31,0.421,0500000US28157,Wilkinson County,8587,70,8517,8326,2525,5764,16,8,0,13,191,0.462,0.042,0.099,4.2%,9.9%
0500000US28159,28159,28,159,"Winston County, Mississippi",19198,184,19014,18879,9891,8729,215,37,3,4,135,0.528,0500000US28159,Winston County,17714,226,17488,17155,8856,8078,162,39,1,19,333,0.541,0.014,0.026,1.4%,2.6%
0500000US28161,28161,28,161,"Yalobusha County, Mississippi",12678,151,12527,12433,7606,4772,30,20,1,4,94,0.498,0500000US28161,Yalobusha County,12481,163,12318,12009,7331,4615,24,21,2,16,309,0.517,0.019,0.039,1.9%,3.9%
0500000US28163,28163,28,163,"Yazoo County, Mississippi",28065,1301,26764,26562,10477,15893,59,124,4,5,202,0.538,0500000US28163,Yazoo County,26743,1076,25667,25203,9184,15812,50,115,6,36,464,0.531,-0.007,-0.013,-0.7%,-1.3%
0500000US29001,29001,29,1,"Adair County, Missouri",25607,523,25084,24694,23751,392,72,453,12,14,390,0.139,0500000US29001,Adair County,25314,661,24653,23644,21590,1265,41,685,13,50,1009,0.267,0.129,0.928,12.9%,92.8%
0500000US29003,29003,29,3,"Andrew County, Missouri",17291,290,17001,16836,16641,70,46,75,0,4,165,0.073,0500000US29003,Andrew County,18135,391,17744,17067,16756,138,40,89,0,44,677,0.144,0.071,0.968,7.1%,96.8%
0500000US29005,29005,29,5,"Atchison County, Missouri",5685,55,5630,5594,5556,17,9,9,3,0,36,0.045,0500000US29005,Atchison County,5305,73,5232,5051,4983,22,25,7,0,14,181,0.116,0.072,1.601,7.2%,160.1%
0500000US29007,29007,29,7,"Audrain County, Missouri",25529,665,24864,24466,22613,1637,81,115,4,16,398,0.210,0500000US29007,Audrain County,24962,731,24231,23014,21450,1304,63,114,2,81,1217,0.256,0.045,0.215,4.5%,21.5%
0500000US29009,29009,29,9,"Barry County, Missouri",35597,2745,32852,32354,31505,87,289,459,6,8,498,0.210,0500000US29009,Barry County,34534,3333,31201,29435,28058,102,316,808,70,81,1766,0.327,0.117,0.556,11.7%,55.6%
0500000US29011,29011,29,11,"Barton County, Missouri",12402,231,12171,11910,11704,42,129,29,2,4,261,0.108,0500000US29011,Barton County,11637,266,11371,10593,10367,27,145,37,2,15,778,0.201,0.093,0.855,9.3%,85.5%
0500000US29013,29013,29,13,"Bates County, Missouri",17049,275,16774,16567,16296,143,94,27,2,5,207,0.086,0500000US29013,Bates County,16042,335,15707,15124,14799,155,92,48,9,21,583,0.147,0.061,0.713,6.1%,71.3%
0500000US29015,29015,29,15,"Benton County, Missouri",19056,291,18765,18537,18311,56,105,53,5,7,228,0.076,0500000US29015,Benton County,19394,310,19084,18204,17934,75,100,51,0,44,880,0.143,0.066,0.869,6.6%,86.9%
0500000US29017,29017,29,17,"Bollinger County, Missouri",12363,98,12265,12172,12037,32,73,26,0,4,93,0.052,0500000US29017,Bollinger County,10567,153,10414,9972,9862,35,30,20,3,22,442,0.127,0.075,1.448,7.5%,144.8%
0500000US29019,29019,29,19,"Boone County, Missouri",162642,4895,157747,153651,131677,14943,523,6112,82,314,4096,0.333,0500000US29019,Boone County,183610,8052,175558,164987,137771,17882,452,7772,120,990,10571,0.420,0.087,0.262,8.7%,26.2%
0500000US29021,29021,29,21,"Buchanan County, Missouri",89201,4674,84527,82762,76937,4572,327,704,149,73,1765,0.250,0500000US29021,Buchanan County,84793,5600,79193,74728,68391,4303,323,1048,426,237,4465,0.340,0.089,0.357,8.9%,35.7%
0500000US29023,29023,29,23,"Butler County, Missouri",42794,666,42128,41287,38504,2235,215,283,15,35,841,0.187,0500000US29023,Butler County,42130,901,41229,38822,35745,2463,198,304,12,100,2407,0.273,0.086,0.459,8.6%,45.9%
0500000US29025,29025,29,25,"Caldwell County, Missouri",9424,143,9281,9130,9035,39,33,18,2,3,151,0.080,0500000US29025,Caldwell County,8815,151,8664,8327,8172,65,34,26,7,23,337,0.139,0.058,0.727,5.8%,72.7%
0500000US29027,29027,29,27,"Callaway County, Missouri",44332,707,43625,42850,40350,2006,204,236,15,39,775,0.169,0500000US29027,Callaway County,44283,965,43318,40951,38453,1943,141,222,30,162,2367,0.241,0.072,0.425,7.2%,42.5%
0500000US29029,29029,29,29,"Camden County, Missouri",44002,1014,42988,42486,41913,170,199,175,7,22,502,0.092,0500000US29029,Camden County,42745,1355,41390,39515,38714,247,177,221,28,128,1875,0.177,0.085,0.921,8.5%,92.1%
0500000US29031,29031,29,31,"Cape Girardeau County, Missouri",75674,1476,74198,72960,66532,5290,171,887,19,61,1238,0.221,0500000US29031,Cape Girardeau County,81710,2234,79476,75538,67393,6459,170,1300,14,202,3938,0.310,0.089,0.401,8.9%,40.1%
0500000US29033,29033,29,33,"Carroll County, Missouri",9295,118,9177,9082,8893,149,21,10,8,1,95,0.084,0500000US29033,Carroll County,8495,132,8363,8039,7906,97,15,15,0,6,324,0.132,0.048,0.570,4.8%,57.0%
0500000US29035,29035,29,35,"Carter County, Missouri",6265,104,6161,6075,5992,5,65,9,1,3,86,0.085,0500000US29035,Carter County,5202,97,5105,4844,4794,11,17,18,1,3,261,0.148,0.063,0.746,6.3%,74.6%
0500000US29037,29037,29,37,"Cass County, Missouri",99478,3988,95490,93778,89079,3444,504,623,62,66,1712,0.195,0500000US29037,Cass County,107824,5583,102241,96161,89406,4904,502,841,78,430,6080,0.304,0.109,0.561,10.9%,56.1%
0500000US29039,29039,29,39,"Cedar County, Missouri",13982,204,13778,13565,13432,14,72,44,3,0,213,0.077,0500000US29039,Cedar County,14188,261,13927,13139,12899,57,100,42,7,34,788,0.170,0.093,1.217,9.3%,121.7%
0500000US29041,29041,29,41,"Chariton County, Missouri",7831,40,7791,7727,7544,155,18,7,0,3,64,0.071,0500000US29041,Chariton County,7408,101,7307,7091,6925,144,15,3,3,1,216,0.125,0.053,0.745,5.3%,74.5%
0500000US29043,29043,29,43,"Christian County, Missouri",77422,1898,75524,74321,72982,433,442,385,50,29,1203,0.110,0500000US29043,Christian County,88842,3012,85830,80887,78890,597,468,624,68,240,4943,0.207,0.097,0.875,9.7%,87.5%
0500000US29045,29045,29,45,"Clark County, Missouri",7139,42,7097,7027,6978,19,8,22,0,0,70,0.044,0500000US29045,Clark County,6634,50,6584,6389,6337,21,9,12,0,10,195,0.087,0.042,0.948,4.2%,94.8%
0500000US29047,29047,29,47,"Clay County, Missouri",221939,13101,208838,204170,186611,11220,1015,4503,549,272,4668,0.286,0500000US29047,Clay County,253335,18850,234485,220219,193282,17853,1009,6059,1004,1012,14266,0.404,0.118,0.411,11.8%,41.1%
0500000US29049,29049,29,49,"Clinton County, Missouri",20743,322,20421,20122,19606,284,144,72,2,14,299,0.106,0500000US29049,Clinton County,21184,502,20682,19676,19264,202,71,85,5,49,1006,0.170,0.064,0.606,6.4%,60.6%
0500000US29051,29051,29,51,"Cole County, Missouri",75990,1795,74195,72951,63247,8421,214,956,44,69,1244,0.294,0500000US29051,Cole County,77279,2661,74618,71016,61474,8041,175,965,56,305,3602,0.353,0.059,0.200,5.9%,20.0%
0500000US29053,29053,29,53,"Cooper County, Missouri",17601,232,17369,17092,15754,1201,49,77,3,8,277,0.194,0500000US29053,Cooper County,17103,322,16781,15838,14730,920,53,67,6,62,943,0.252,0.058,0.300,5.8%,30.0%
0500000US29055,29055,29,55,"Crawford County, Missouri",24696,365,24331,24065,23804,64,105,73,11,8,266,0.071,0500000US29055,Crawford County,23056,482,22574,21369,20980,148,107,81,14,39,1205,0.169,0.098,1.391,9.8%,139.1%
0500000US29057,29057,29,57,"Dade County, Missouri",7883,121,7762,7602,7476,29,70,22,3,2,160,0.100,0500000US29057,Dade County,7569,135,7434,7103,6995,34,50,24,0,0,331,0.144,0.044,0.438,4.4%,43.8%
0500000US29059,29059,29,59,"Dallas County, Missouri",16777,260,16517,16256,16037,29,139,40,8,3,261,0.086,0500000US29059,Dallas County,17071,320,16751,15915,15696,44,92,25,15,43,836,0.152,0.066,0.771,6.6%,77.1%
0500000US29061,29061,29,61,"Daviess County, Missouri",8433,87,8346,8264,8211,23,23,5,2,0,82,0.052,0500000US29061,Daviess County,8430,113,8317,8015,7924,31,27,16,10,7,302,0.115,0.063,1.222,6.3%,122.2%
0500000US29063,29063,29,63,"DeKalb County, Missouri",12892,219,12673,12591,11045,1454,49,31,12,0,82,0.253,0500000US29063,DeKalb County,11029,227,10802,10423,9653,672,30,42,2,24,379,0.229,-0.024,-0.096,-2.4%,-9.6%
0500000US29065,29065,29,65,"Dent County, Missouri",15657,148,15509,15264,15021,55,135,41,7,5,245,0.079,0500000US29065,Dent County,14421,271,14150,13424,13203,52,61,54,7,47,726,0.159,0.080,1.007,8.0%,100.7%
0500000US29067,29067,29,67,"Douglas County, Missouri",13684,110,13574,13353,13218,28,74,30,0,3,221,0.067,0500000US29067,Douglas County,11578,239,11339,10763,10602,35,74,24,0,28,576,0.159,0.092,1.381,9.2%,138.1%
0500000US29069,29069,29,69,"Dunklin County, Missouri",31953,1727,30226,29774,26498,3081,67,107,7,14,452,0.300,0500000US29069,Dunklin County,28283,2042,26241,25022,21629,3176,70,78,4,65,1219,0.395,0.096,0.319,9.6%,31.9%
0500000US29071,29071,29,71,"Franklin County, Missouri",101492,1397,100095,99030,97390,847,290,410,30,63,1065,0.079,0500000US29071,Franklin County,104682,2205,102477,97697,95680,880,291,532,31,283,4780,0.162,0.083,1.055,8.3%,105.5%
0500000US29073,29073,29,73,"Gasconade County, Missouri",15222,152,15070,14918,14801,26,26,53,6,6,152,0.054,0500000US29073,Gasconade County,14794,189,14605,13832,13705,18,25,51,9,24,773,0.139,0.085,1.556,8.5%,155.6%
0500000US29075,29075,29,75,"Gentry County, Missouri",6738,36,6702,6657,6604,20,12,18,0,3,45,0.039,0500000US29075,Gentry County,6162,90,6072,5891,5851,15,6,9,1,9,181,0.097,0.058,1.477,5.8%,147.7%
0500000US29077,29077,29,77,"Greene County, Missouri",275174,8207,266967,260771,246378,7738,1667,4489,291,208,6196,0.196,0500000US29077,Greene County,298915,14392,284523,265748,246368,9987,1735,6182,375,1101,18775,0.313,0.117,0.597,11.7%,59.7%
0500000US29079,29079,29,79,"Grundy County, Missouri",10261,178,10083,9994,9854,58,38,36,2,6,89,0.077,0500000US29079,Grundy County,9808,241,9567,9281,9121,50,33,54,8,15,286,0.134,0.056,0.729,5.6%,72.9%
0500000US29081,29081,29,81,"Harrison County, Missouri",8957,141,8816,8746,8659,28,28,16,9,6,70,0.065,0500000US29081,Harrison County,8157,168,7989,7716,7618,32,30,23,3,10,273,0.126,0.061,0.939,6.1%,93.9%
0500000US29083,29083,29,83,"Henry County, Missouri",22272,369,21903,21623,21230,219,101,52,13,8,280,0.091,0500000US29083,Henry County,21946,573,21373,20230,19800,177,89,91,6,67,1143,0.183,0.092,1.009,9.2%,100.9%
0500000US29085,29085,29,85,"Hickory County, Missouri",9627,91,9536,9394,9278,24,67,16,8,1,142,0.071,0500000US29085,Hickory County,8279,132,8147,7744,7648,11,42,15,0,28,403,0.144,0.073,1.033,7.3%,103.3%
0500000US29087,29087,29,87,"Holt County, Missouri",4912,39,4873,4849,4775,7,48,15,1,3,24,0.055,0500000US29087,Holt County,4223,67,4156,4046,3992,4,30,2,0,18,110,0.105,0.051,0.923,5.1%,92.3%
0500000US29089,29089,29,89,"Howard County, Missouri",10144,122,10022,9845,9240,527,45,25,3,5,177,0.167,0500000US29089,Howard County,10151,208,9943,9478,8826,542,34,27,3,46,465,0.239,0.071,0.428,7.1%,42.8%
0500000US29091,29091,29,91,"Howell County, Missouri",40400,697,39703,39125,38499,154,249,195,14,14,578,0.091,0500000US29091,Howell County,39750,896,38854,36760,35972,180,265,217,17,109,2094,0.178,0.086,0.946,8.6%,94.6%
0500000US29093,29093,29,93,"Iron County, Missouri",10630,133,10497,10357,10162,131,51,11,0,2,140,0.086,0500000US29093,Iron County,9537,177,9360,8838,8602,136,60,34,2,4,522,0.183,0.097,1.136,9.7%,113.6%
0500000US29095,29095,29,95,"Jackson County, Missouri",674158,56434,617724,601643,426574,159442,2668,10621,1492,846,16081,0.536,0500000US29095,Jackson County,717204,77785,639419,598588,419542,156542,2713,14981,1727,3083,40831,0.595,0.059,0.110,5.9%,11.0%
0500000US29097,29097,29,97,"Jasper County, Missouri",117404,8027,109377,106287,101019,2166,1617,1160,233,92,3090,0.254,0500000US29097,Jasper County,122761,11377,111384,102861,96388,2260,1894,1491,440,388,8523,0.369,0.116,0.456,11.6%,45.6%
0500000US29099,29099,29,99,"Jefferson County, Missouri",218733,3408,215325,212697,208742,1776,608,1403,48,120,2628,0.089,0500000US29099,Jefferson County,226739,5552,221187,208731,203287,2295,617,1839,71,622,12456,0.192,0.104,1.167,10.4%,116.7%
0500000US29101,29101,29,101,"Johnson County, Missouri",52595,1611,50984,49784,46367,2227,245,781,120,44,1200,0.219,0500000US29101,Johnson County,54013,2595,51418,48217,44415,2309,259,821,210,203,3201,0.316,0.097,0.440,9.7%,44.0%
0500000US29103,29103,29,103,"Knox County, Missouri",4131,34,4097,4056,4027,14,7,8,0,0,41,0.050,0500000US29103,Knox County,3744,23,3721,3622,3573,20,5,18,0,6,99,0.088,0.039,0.786,3.9%,78.6%
0500000US29105,29105,29,105,"Laclede County, Missouri",35571,719,34852,34243,33596,237,229,148,16,17,609,0.107,0500000US29105,Laclede County,36039,955,35084,33219,32482,262,197,190,17,71,1865,0.184,0.077,0.719,7.7%,71.9%
0500000US29107,29107,29,107,"Lafayette County, Missouri",33381,740,32641,32049,31002,726,131,125,45,20,592,0.136,0500000US29107,Lafayette County,32984,1047,31937,30250,29256,671,138,115,12,58,1687,0.209,0.073,0.537,7.3%,53.7%
0500000US29109,29109,29,109,"Lawrence County, Missouri",38634,2444,36190,35669,35140,83,301,124,10,11,521,0.168,0500000US29109,Lawrence County,38001,2987,35014,33170,32401,134,333,171,40,91,1844,0.264,0.096,0.569,9.6%,56.9%
0500000US29111,29111,29,111,"Lewis County, Missouri",10211,159,10052,9924,9546,321,25,22,7,3,128,0.125,0500000US29111,Lewis County,10032,165,9867,9562,9315,185,30,22,0,10,305,0.136,0.012,0.094,1.2%,9.4%
0500000US29113,29113,29,113,"Lincoln County, Missouri",52566,1032,51534,50711,49364,963,154,191,11,28,823,0.117,0500000US29113,Lincoln County,59574,1541,58033,54755,53051,1072,193,235,27,177,3278,0.203,0.086,0.733,8.6%,73.3%
0500000US29115,29115,29,115,"Linn County, Missouri",12761,193,12568,12438,12297,85,26,26,1,3,130,0.071,0500000US29115,Linn County,11874,289,11585,11178,11027,67,31,22,6,25,407,0.136,0.065,0.912,6.5%,91.2%
0500000US29117,29117,29,117,"Livingston County, Missouri",15195,181,15014,14843,14386,365,45,40,3,4,171,0.103,0500000US29117,Livingston County,14557,239,14318,13841,13368,315,47,87,5,19,477,0.155,0.052,0.506,5.2%,50.6%
0500000US29119,29119,29,119,"McDonald County, Missouri",23083,2587,20496,19870,18700,127,599,186,255,3,626,0.330,0500000US29119,McDonald County,23303,2818,20485,18907,16667,421,493,376,868,82,1578,0.467,0.137,0.417,13.7%,41.7%
0500000US29121,29121,29,121,"Macon County, Missouri",15566,150,15416,15194,14735,349,30,63,9,8,222,0.103,0500000US29121,Macon County,15209,276,14933,14227,13778,299,25,84,4,37,706,0.176,0.073,0.711,7.3%,71.1%
0500000US29123,29123,29,123,"Madison County, Missouri",12226,244,11982,11892,11781,32,34,41,1,3,90,0.071,0500000US29123,Madison County,12626,342,12284,11721,11555,54,49,41,0,22,563,0.160,0.089,1.249,8.9%,124.9%
0500000US29125,29125,29,125,"Maries County, Missouri",9176,75,9101,9000,8912,24,52,5,1,6,101,0.056,0500000US29125,Maries County,8432,134,8298,7884,7796,23,42,7,0,16,414,0.142,0.086,1.522,8.6%,152.2%
0500000US29127,29127,29,127,"Marion County, Missouri",28781,391,28390,27845,26202,1400,46,153,20,24,545,0.168,0500000US29127,Marion County,28525,516,28009,26637,24930,1363,67,165,16,96,1372,0.231,0.063,0.374,6.3%,37.4%
0500000US29129,29129,29,129,"Mercer County, Missouri",3785,28,3757,3725,3683,6,17,19,0,0,32,0.053,0500000US29129,Mercer County,3538,155,3383,3306,3291,0,8,0,0,7,77,0.132,0.079,1.497,7.9%,149.7%
0500000US29131,29131,29,131,"Miller County, Missouri",24748,343,24405,24089,23762,95,123,69,36,4,316,0.078,0500000US29131,Miller County,24722,466,24256,23271,22908,117,113,64,24,45,985,0.139,0.062,0.794,6.2%,79.4%
0500000US29133,29133,29,133,"Mississippi County, Missouri",14358,231,14127,14001,10521,3423,29,19,1,8,126,0.406,0500000US29133,Mississippi County,12577,223,12354,11979,8814,3060,33,20,0,52,375,0.448,0.043,0.105,4.3%,10.5%
0500000US29135,29135,29,135,"Moniteau County, Missouri",15607,586,15021,14861,14160,580,54,48,9,10,160,0.174,0500000US29135,Moniteau County,15473,864,14609,14095,13688,282,40,42,16,27,514,0.213,0.039,0.224,3.9%,22.4%
0500000US29137,29137,29,137,"Monroe County, Missouri",8840,85,8755,8653,8340,263,22,27,1,0,102,0.109,0500000US29137,Monroe County,8666,159,8507,8160,7902,177,32,31,1,17,347,0.166,0.057,0.527,5.7%,52.7%
0500000US29139,29139,29,139,"Montgomery County, Missouri",12236,172,12064,11899,11642,199,22,31,2,3,165,0.094,0500000US29139,Montgomery County,11322,229,11093,10644,10444,101,22,50,5,22,449,0.147,0.053,0.562,5.3%,56.2%
0500000US29141,29141,29,141,"Morgan County, Missouri",20565,365,20200,19890,19573,123,113,75,2,4,310,0.094,0500000US29141,Morgan County,21006,446,20560,19655,19298,126,105,61,8,57,905,0.154,0.060,0.643,6.0%,64.3%
0500000US29143,29143,29,143,"New Madrid County, Missouri",18956,214,18742,18493,15380,2983,40,75,7,8,249,0.317,0500000US29143,New Madrid County,16434,253,16181,15456,12610,2731,25,62,1,27,725,0.381,0.065,0.205,6.5%,20.5%
0500000US29145,29145,29,145,"Newton County, Missouri",58114,2537,55577,53968,50967,429,1286,758,488,40,1609,0.227,0500000US29145,Newton County,58648,3607,55041,51151,47551,523,1351,798,790,138,3890,0.333,0.106,0.467,10.6%,46.7%
0500000US29147,29147,29,147,"Nodaway County, Missouri",23370,302,23068,22876,21881,563,41,377,3,11,192,0.122,0500000US29147,Nodaway County,21241,427,20814,20122,19290,363,31,390,2,46,692,0.173,0.051,0.416,5.1%,41.6%
0500000US29149,29149,29,149,"Oregon County, Missouri",10881,131,10750,10578,10407,15,115,32,4,5,172,0.085,0500000US29149,Oregon County,8635,117,8518,8102,7990,25,65,8,0,14,416,0.141,0.057,0.667,5.7%,66.7%
0500000US29151,29151,29,151,"Osage County, Missouri",13878,84,13794,13730,13654,28,29,14,4,1,64,0.032,0500000US29151,Osage County,13274,125,13149,12763,12688,24,28,3,10,10,386,0.085,0.053,1.673,5.3%,167.3%
0500000US29153,29153,29,153,"Ozark County, Missouri",9723,128,9595,9471,9387,11,58,13,0,2,124,0.068,0500000US29153,Ozark County,8553,109,8444,8117,8000,19,38,14,5,41,327,0.123,0.056,0.828,5.6%,82.8%
0500000US29155,29155,29,155,"Pemiscot County, Missouri",18296,341,17955,17706,12741,4879,37,41,0,8,249,0.443,0500000US29155,Pemiscot County,15661,415,15246,14576,10176,4297,29,35,4,35,670,0.500,0.057,0.128,5.7%,12.8%
0500000US29157,29157,29,157,"Perry County, Missouri",18971,318,18653,18501,18299,70,45,85,1,1,152,0.069,0500000US29157,Perry County,18956,383,18573,17931,17657,102,29,123,0,20,642,0.131,0.062,0.889,6.2%,88.9%
0500000US29159,29159,29,159,"Pettis County, Missouri",42201,3046,39155,38400,36701,1244,137,247,30,41,755,0.237,0500000US29159,Pettis County,42980,4016,38964,36796,34751,1353,159,294,120,119,2168,0.334,0.097,0.408,9.7%,40.8%
0500000US29161,29161,29,161,"Phelps County, Missouri",45156,923,44233,43359,40792,977,221,1313,29,27,874,0.182,0500000US29161,Phelps County,44638,1259,43379,40956,37941,1028,231,1506,20,230,2423,0.272,0.090,0.496,9.0%,49.6%
0500000US29163,29163,29,163,"Pike County, Missouri",18516,331,18185,17960,16519,1327,38,43,3,30,225,0.198,0500000US29163,Pike County,17587,434,17153,16427,15383,942,40,23,7,32,726,0.230,0.031,0.158,3.1%,15.8%
0500000US29165,29165,29,165,"Platte County, Missouri",89322,4424,84898,83093,75135,5147,370,2031,287,123,1805,0.286,0500000US29165,Platte County,106718,7161,99557,93827,81426,8135,391,2721,695,459,5730,0.404,0.118,0.414,11.8%,41.4%
0500000US29167,29167,29,167,"Polk County, Missouri",31137,615,30522,30103,29565,226,190,104,9,9,419,0.098,0500000US29167,Polk County,31519,791,30728,29310,28682,242,190,131,4,61,1418,0.169,0.071,0.730,7.1%,73.0%
0500000US29169,29169,29,169,"Pulaski County, Missouri",52274,4705,47569,45557,37863,5680,352,1295,292,75,2012,0.453,0500000US29169,Pulaski County,53955,6079,47876,44636,35865,6039,334,1776,402,220,3240,0.528,0.075,0.165,7.5%,16.5%
0500000US29171,29171,29,171,"Putnam County, Missouri",4979,36,4943,4904,4865,9,7,22,1,0,39,0.045,0500000US29171,Putnam County,4681,112,4569,4462,4446,11,5,0,0,0,107,0.097,0.052,1.145,5.2%,114.5%
0500000US29173,29173,29,173,"Ralls County, Missouri",10167,98,10069,9985,9828,107,14,19,12,5,84,0.065,0500000US29173,Ralls County,10355,96,10259,9915,9713,114,26,17,4,41,344,0.119,0.054,0.820,5.4%,82.0%
0500000US29175,29175,29,175,"Randolph County, Missouri",25414,413,25001,24526,22865,1477,66,105,3,10,475,0.187,0500000US29175,Randolph County,24716,572,24144,22903,21271,1351,102,95,9,75,1241,0.253,0.067,0.358,6.7%,35.8%
0500000US29177,29177,29,177,"Ray County, Missouri",23494,415,23079,22795,22338,265,114,60,15,3,284,0.095,0500000US29177,Ray County,23158,580,22578,21390,20893,227,133,76,8,53,1188,0.183,0.087,0.915,8.7%,91.5%
0500000US29179,29179,29,179,"Reynolds County, Missouri",6696,64,6632,6529,6433,45,37,12,1,1,103,0.077,0500000US29179,Reynolds County,6096,99,5997,5745,5669,33,23,18,2,0,252,0.133,0.057,0.738,5.7%,73.8%
0500000US29181,29181,29,181,"Ripley County, Missouri",14100,142,13958,13782,13563,49,122,44,0,4,176,0.074,0500000US29181,Ripley County,10679,127,10552,9990,9885,31,44,28,1,1,562,0.140,0.066,0.886,6.6%,88.6%
0500000US29183,29183,29,183,"St. Charles County, Missouri",360485,9983,350502,344966,321078,14827,692,7789,153,427,5536,0.204,0500000US29183,St. Charles County,405262,16011,389251,369818,335879,20672,623,11068,199,1377,19433,0.306,0.102,0.503,10.2%,50.3%
0500000US29185,29185,29,185,"St. Clair County, Missouri",9805,170,9635,9485,9366,47,58,12,1,1,150,0.087,0500000US29185,St. Clair County,9284,178,9106,8705,8567,26,63,19,7,23,401,0.146,0.059,0.681,5.9%,68.1%
0500000US29186,29186,29,186,"Ste. Genevieve County, Missouri",18145,149,17996,17828,17607,117,52,49,1,2,168,0.058,0500000US29186,Ste. Genevieve County,18479,269,18210,17551,17127,320,54,29,2,19,659,0.139,0.081,1.391,8.1%,139.1%
0500000US29187,29187,29,187,"St. Francois County, Missouri",65359,778,64581,63904,60631,2759,228,242,32,12,677,0.137,0500000US29187,St. Francois County,66922,1089,65833,62923,59474,2645,192,403,21,188,2910,0.206,0.069,0.503,6.9%,50.3%
0500000US29189,29189,29,189,"St. Louis County, Missouri",998954,25024,973930,957343,687984,231801,1632,34466,273,1187,16587,0.470,0500000US29189,St. Louis County,1004125,37178,966947,924897,624703,245168,1474,48552,264,4736,42050,0.548,0.078,0.166,7.8%,16.6%
0500000US29195,29195,29,195,"Saline County, Missouri",23370,1925,21445,21003,19441,1217,49,123,152,21,442,0.298,0500000US29195,Saline County,23333,2830,20503,19495,17473,1149,68,175,397,233,1008,0.420,0.122,0.408,12.2%,40.8%
0500000US29197,29197,29,197,"Schuyler County, Missouri",4431,29,4402,4371,4353,1,7,10,0,0,31,0.035,0500000US29197,Schuyler County,4032,47,3985,3890,3864,0,1,15,1,9,95,0.081,0.046,1.325,4.6%,132.5%
0500000US29199,29199,29,199,"Scotland County, Missouri",4843,33,4810,4787,4760,3,12,11,0,1,23,0.034,0500000US29199,Scotland County,4716,35,4681,4554,4537,6,5,5,1,0,127,0.074,0.040,1.174,4.0%,117.4%
0500000US29201,29201,29,201,"Scott County, Missouri",39191,705,38486,37923,33257,4436,77,133,8,12,563,0.267,0500000US29201,Scott County,38059,935,37124,35403,30595,4476,84,149,2,97,1721,0.337,0.071,0.265,7.1%,26.5%
0500000US29203,29203,29,203,"Shannon County, Missouri",8441,139,8302,8122,8014,16,76,15,0,1,180,0.098,0500000US29203,Shannon County,7031,141,6890,6507,6451,3,37,13,0,3,383,0.155,0.057,0.583,5.7%,58.3%
0500000US29205,29205,29,205,"Shelby County, Missouri",6373,71,6302,6256,6202,32,9,13,0,0,46,0.053,0500000US29205,Shelby County,6103,117,5986,5799,5749,20,20,1,0,9,187,0.111,0.059,1.111,5.9%,111.1%
0500000US29207,29207,29,207,"Stoddard County, Missouri",29968,356,29612,29352,28931,274,91,51,2,3,260,0.068,0500000US29207,Stoddard County,28672,566,28106,27100,26610,298,67,90,2,33,1006,0.137,0.069,1.022,6.9%,102.2%
0500000US29209,29209,29,209,"Stone County, Missouri",32202,553,31649,31277,30938,46,172,95,8,18,372,0.076,0500000US29209,Stone County,31076,782,30294,28809,28296,79,215,115,20,84,1485,0.168,0.091,1.195,9.1%,119.5%
0500000US29211,29211,29,211,"Sullivan County, Missouri",6714,1248,5466,5425,5350,30,32,8,1,4,41,0.330,0500000US29211,Sullivan County,5999,1054,4945,4785,4507,208,26,29,1,14,160,0.403,0.072,0.219,7.2%,21.9%
0500000US29213,29213,29,213,"Taney County, Missouri",51675,2494,49181,48286,47083,405,376,329,40,53,895,0.167,0500000US29213,Taney County,56066,4329,51737,48689,46468,837,407,608,187,182,3048,0.304,0.137,0.818,13.7%,81.8%
0500000US29215,29215,29,215,"Texas County, Missouri",26008,425,25583,25146,24010,871,167,80,7,11,437,0.146,0500000US29215,Texas County,24487,515,23972,23031,21992,780,142,65,6,46,941,0.190,0.044,0.304,4.4%,30.4%
0500000US29217,29217,29,217,"Vernon County, Missouri",21159,336,20823,20553,20197,100,141,103,8,4,270,0.088,0500000US29217,Vernon County,19707,426,19281,18380,17966,110,131,103,18,52,901,0.166,0.078,0.881,7.8%,88.1%
0500000US29219,29219,29,219,"Warren County, Missouri",32513,957,31556,31053,30201,598,113,123,10,8,503,0.136,0500000US29219,Warren County,35532,1400,34132,32191,31103,718,116,143,0,111,1941,0.229,0.093,0.686,9.3%,68.6%
0500000US29221,29221,29,221,"Washington County, Missouri",25195,255,24940,24679,23969,554,95,48,5,8,261,0.094,0500000US29221,Washington County,23514,227,23287,22160,21378,610,78,40,1,53,1127,0.170,0.076,0.808,7.6%,80.8%
0500000US29223,29223,29,223,"Wayne County, Missouri",13521,140,13381,13180,13053,33,55,32,2,5,201,0.068,0500000US29223,Wayne County,10974,155,10819,10240,10093,50,67,23,5,2,579,0.151,0.083,1.232,8.3%,123.2%
0500000US29225,29225,29,225,"Webster County, Missouri",36202,612,35590,35097,34469,320,221,70,6,11,493,0.093,0500000US29225,Webster County,39085,790,38295,36566,35893,194,243,141,9,86,1729,0.154,0.061,0.661,6.1%,66.1%
0500000US29227,29227,29,227,"Worth County, Missouri",2171,23,2148,2140,2115,11,5,6,0,3,8,0.051,0500000US29227,Worth County,1973,25,1948,1900,1887,0,4,4,5,0,48,0.085,0.034,0.665,3.4%,66.5%
0500000US29229,29229,29,229,"Wright County, Missouri",18815,238,18577,18368,18123,87,96,51,8,3,209,0.072,0500000US29229,Wright County,18188,370,17818,16950,16654,111,73,48,5,59,868,0.159,0.087,1.210,8.7%,121.0%
0500000US29510,29510,29,510,"St. Louis city, Missouri",319294,11130,308164,301548,134702,156389,684,9233,62,478,6616,0.580,0500000US29510,St. Louis city,301578,15405,286173,273041,129368,128993,614,12205,88,1773,13132,0.627,0.047,0.081,4.7%,8.1%
0500000US30001,30001,30,1,"Beaverhead County, Montana",9246,338,8908,8784,8567,19,117,36,38,7,124,0.140,0500000US30001,Beaverhead County,9371,431,8940,8554,8330,24,120,37,3,40,386,0.206,0.066,0.473,6.6%,47.3%
0500000US30003,30003,30,3,"Big Horn County, Montana",12865,510,12355,12060,3908,30,8053,59,3,7,295,0.514,0500000US30003,Big Horn County,13124,515,12609,12101,3407,11,8627,44,9,3,508,0.497,-0.016,-0.032,-1.6%,-3.2%
0500000US30005,30005,30,5,"Blaine County, Montana",6491,115,6376,6261,3107,7,3138,6,1,2,115,0.537,0500000US30005,Blaine County,7044,158,6886,6621,2942,10,3621,13,0,35,265,0.559,0.023,0.043,2.3%,4.3%
0500000US30007,30007,30,7,"Broadwater County, Montana",5612,126,5486,5413,5310,15,68,9,11,0,73,0.104,0500000US30007,Broadwater County,6774,200,6574,6239,6149,17,44,5,0,24,335,0.173,0.069,0.662,6.9%,66.2%
0500000US30009,30009,30,9,"Carbon County, Montana",10078,188,9890,9801,9668,30,76,22,3,2,89,0.079,0500000US30009,Carbon County,10473,261,10212,9779,9603,13,97,21,0,45,433,0.157,0.078,0.979,7.8%,97.9%
0500000US30011,30011,30,11,"Carter County, Montana",1160,8,1152,1145,1132,1,11,1,0,0,7,0.048,0500000US30011,Carter County,1415,11,1404,1353,1341,0,7,1,0,4,51,0.100,0.053,1.114,5.3%,111.4%
0500000US30013,30013,30,13,"Cascade County, Montana",81327,2711,78616,76120,71100,958,3274,665,78,45,2496,0.232,0500000US30013,Cascade County,84414,4012,80402,75058,68794,1085,3725,908,105,441,5344,0.327,0.096,0.412,9.6%,41.2%
0500000US30015,30015,30,15,"Chouteau County, Montana",5813,94,5719,5631,4387,1,1213,21,6,3,88,0.386,0500000US30015,Chouteau County,5895,159,5736,5557,4172,10,1347,18,0,10,179,0.445,0.059,0.152,5.9%,15.2%
0500000US30017,30017,30,17,"Custer County, Montana",11699,263,11436,11271,11009,31,185,37,3,6,165,0.114,0500000US30017,Custer County,11867,362,11505,11036,10701,71,192,52,7,13,469,0.184,0.071,0.621,7.1%,62.1%
0500000US30019,30019,30,19,"Daniels County, Montana",1751,27,1724,1697,1653,3,36,4,0,1,27,0.108,0500000US30019,Daniels County,1661,49,1612,1514,1467,0,34,13,0,0,98,0.215,0.107,0.994,10.7%,99.4%
0500000US30021,30021,30,21,"Dawson County, Montana",8966,178,8788,8675,8477,25,141,26,3,3,113,0.105,0500000US30021,Dawson County,8940,288,8652,8261,7969,38,166,57,1,30,391,0.202,0.097,0.919,9.7%,91.9%
0500000US30023,30023,30,23,"Deer Lodge County, Montana",9298,271,9027,8828,8518,36,242,28,2,2,199,0.159,0500000US30023,Deer Lodge County,9421,260,9161,8809,8514,23,222,33,2,15,352,0.181,0.022,0.137,2.2%,13.7%
0500000US30025,30025,30,25,"Fallon County, Montana",2890,34,2856,2823,2793,2,9,17,2,0,33,0.066,0500000US30025,Fallon County,3049,63,2986,2898,2858,5,27,5,2,1,88,0.120,0.054,0.827,5.4%,82.7%
0500000US30027,30027,30,27,"Fergus County, Montana",11586,171,11415,11265,11085,18,135,27,0,0,150,0.084,0500000US30027,Fergus County,11446,225,11221,10782,10566,21,124,38,0,33,439,0.146,0.062,0.735,6.2%,73.5%
0500000US30029,30029,30,29,"Flathead County, Montana",90928,2070,88858,87176,85439,180,934,522,50,51,1682,0.116,0500000US30029,Flathead County,104357,3329,101028,95855,93416,269,931,703,77,459,5173,0.195,0.079,0.680,7.9%,68.0%
0500000US30031,30031,30,31,"Gallatin County, Montana",89513,2470,87043,85663,83545,277,718,1011,56,56,1380,0.128,0500000US30031,Gallatin County,118960,5895,113065,107447,104003,493,922,1389,91,549,5618,0.231,0.103,0.807,10.3%,80.7%
0500000US30033,30033,30,33,"Garfield County, Montana",1206,3,1203,1197,1187,3,5,1,0,1,6,0.031,0500000US30033,Garfield County,1173,14,1159,1137,1125,0,9,2,1,0,22,0.080,0.048,1.551,4.8%,155.1%
0500000US30035,30035,30,35,"Glacier County, Montana",13399,241,13158,12810,4117,17,8644,26,1,5,348,0.488,0500000US30035,Glacier County,13778,301,13477,12665,3496,19,9085,39,16,10,812,0.497,0.008,0.017,0.8%,1.7%
0500000US30037,30037,30,37,"Golden Valley County, Montana",884,31,853,842,822,0,9,6,0,5,11,0.134,0500000US30037,Golden Valley County,823,35,788,744,724,7,1,0,1,11,44,0.221,0.087,0.653,8.7%,65.3%
0500000US30039,30039,30,39,"Granite County, Montana",3079,44,3035,2989,2968,3,13,2,1,2,46,0.070,0500000US30039,Granite County,3309,85,3224,3106,3066,0,24,3,0,13,118,0.139,0.069,0.983,6.9%,98.3%
0500000US30041,30041,30,41,"Hill County, Montana",16096,373,15723,15255,11741,47,3393,66,6,2,468,0.422,0500000US30041,Hill County,16309,500,15809,14846,11020,44,3671,79,8,24,963,0.488,0.066,0.157,6.6%,15.7%
0500000US30043,30043,30,43,"Jefferson County, Montana",11406,224,11182,10946,10724,16,159,39,2,6,236,0.115,0500000US30043,Jefferson County,12085,291,11794,11194,10926,15,161,49,0,43,600,0.179,0.064,0.560,6.4%,56.0%
0500000US30045,30045,30,45,"Judith Basin County, Montana",2072,24,2048,2034,2014,1,17,2,0,0,14,0.055,0500000US30045,Judith Basin County,2023,49,1974,1911,1883,8,1,4,2,13,63,0.132,0.077,1.402,7.7%,140.2%
0500000US30047,30047,30,47,"Lake County, Montana",28746,998,27748,25826,19568,88,6028,112,16,14,1922,0.487,0500000US30047,Lake County,31134,1168,29966,27336,20373,64,6632,138,21,108,2630,0.518,0.031,0.063,3.1%,6.3%
0500000US30049,30049,30,49,"Lewis and Clark County, Montana",63395,1582,61813,60493,58599,203,1259,350,43,39,1320,0.144,0500000US30049,Lewis and Clark County,70973,2599,68374,64444,62063,266,1233,551,44,287,3930,0.231,0.086,0.600,8.6%,60.0%
0500000US30051,30051,30,51,"Liberty County, Montana",2339,8,2331,2304,2293,2,5,3,1,0,27,0.039,0500000US30051,Liberty County,1959,13,1946,1880,1856,2,10,6,0,6,66,0.101,0.062,1.608,6.2%,160.8%
0500000US30053,30053,30,53,"Lincoln County, Montana",19687,462,19225,18813,18546,20,174,58,9,6,412,0.111,0500000US30053,Lincoln County,19677,561,19116,18160,17725,32,204,100,13,86,956,0.185,0.074,0.662,7.4%,66.2%
0500000US30055,30055,30,55,"McCone County, Montana",1734,13,1721,1701,1689,3,7,2,0,0,20,0.051,0500000US30055,McCone County,1729,32,1697,1636,1592,1,23,8,2,10,61,0.150,0.099,1.947,9.9%,194.7%
0500000US30057,30057,30,57,"Madison County, Montana",7691,186,7505,7416,7335,15,35,26,0,5,89,0.090,0500000US30057,Madison County,8623,239,8384,8076,7955,11,34,30,6,40,308,0.147,0.057,0.637,5.7%,63.7%
0500000US30059,30059,30,59,"Meagher County, Montana",1891,28,1863,1841,1827,2,4,6,0,2,22,0.066,0500000US30059,Meagher County,1927,46,1881,1807,1781,12,4,2,0,8,74,0.144,0.078,1.171,7.8%,117.1%
0500000US30061,30061,30,61,"Mineral County, Montana",4223,80,4143,4051,3952,9,60,30,0,0,92,0.123,0500000US30061,Mineral County,4535,147,4388,4161,4044,10,63,21,5,18,227,0.201,0.078,0.633,7.8%,63.3%
0500000US30063,30063,30,63,"Missoula County, Montana",109299,2861,106438,103962,99489,412,2641,1220,103,97,2476,0.170,0500000US30063,Missoula County,117922,6004,111918,105722,99953,706,3009,1423,122,509,6196,0.275,0.106,0.624,10.6%,62.4%
0500000US30065,30065,30,65,"Musselshell County, Montana",4538,118,4420,4358,4278,10,58,10,2,0,62,0.110,0500000US30065,Musselshell County,4730,146,4584,4404,4274,4,87,22,5,12,180,0.181,0.070,0.639,7.0%,63.9%
0500000US30067,30067,30,67,"Park County, Montana",15636,325,15311,15104,14893,19,120,51,5,16,207,0.092,0500000US30067,Park County,17191,510,16681,15966,15636,62,142,75,0,51,715,0.170,0.078,0.846,7.8%,84.6%
0500000US30069,30069,30,69,"Petroleum County, Montana",494,5,489,486,486,0,0,0,0,0,3,0.032,0500000US30069,Petroleum County,496,5,491,466,466,0,0,0,0,0,25,0.115,0.083,2.585,8.3%,258.5%
0500000US30071,30071,30,71,"Phillips County, Montana",4253,81,4172,4020,3665,1,343,10,1,0,152,0.249,0500000US30071,Phillips County,4217,112,4105,3867,3492,5,329,15,0,26,238,0.304,0.055,0.221,5.5%,22.1%
0500000US30073,30073,30,73,"Pondera County, Montana",6153,87,6066,5949,5060,7,868,13,0,1,117,0.303,0500000US30073,Pondera County,5898,97,5801,5585,4644,4,891,25,11,10,216,0.356,0.052,0.173,5.2%,17.3%
0500000US30075,30075,30,75,"Powder River County, Montana",1743,24,1719,1687,1645,1,27,3,0,11,32,0.108,0500000US30075,Powder River County,1694,35,1659,1575,1529,5,31,0,0,10,84,0.182,0.074,0.678,7.4%,67.8%
0500000US30077,30077,30,77,"Powell County, Montana",7027,117,6910,6828,6425,65,302,31,2,3,82,0.162,0500000US30077,Powell County,6946,161,6785,6525,6016,64,402,23,3,17,260,0.244,0.083,0.512,8.3%,51.2%
0500000US30079,30079,30,79,"Prairie County, Montana",1179,16,1163,1133,1125,0,2,6,0,0,30,0.089,0500000US30079,Prairie County,1088,33,1055,1004,982,2,13,7,0,0,51,0.182,0.093,1.054,9.3%,105.4%
0500000US30081,30081,30,81,"Ravalli County, Montana",40212,1195,39017,38380,37764,72,303,205,21,15,637,0.117,0500000US30081,Ravalli County,44174,1584,42590,40711,39695,88,323,241,29,335,1879,0.189,0.072,0.620,7.2%,62.0%
0500000US30083,30083,30,83,"Richland County, Montana",9746,297,9449,9282,9089,12,156,24,1,0,167,0.129,0500000US30083,Richland County,11491,605,10886,10290,9892,61,165,121,5,46,596,0.253,0.124,0.965,12.4%,96.5%
0500000US30085,30085,30,85,"Roosevelt County, Montana",10425,132,10293,9996,3709,12,6228,45,2,0,297,0.516,0500000US30085,Roosevelt County,10794,239,10555,9838,3587,32,6150,47,0,22,717,0.560,0.044,0.086,4.4%,8.6%
0500000US30087,30087,30,87,"Rosebud County, Montana",9233,313,8920,8701,5556,23,3077,42,3,0,219,0.525,0500000US30087,Rosebud County,8329,234,8095,7758,4768,20,2908,32,2,28,337,0.548,0.023,0.044,2.3%,4.4%
0500000US30089,30089,30,89,"Sanders County, Montana",11413,233,11180,10853,10320,17,475,32,1,8,327,0.179,0500000US30089,Sanders County,12400,346,12054,11331,10732,23,441,56,3,76,723,0.245,0.066,0.368,6.6%,36.8%
0500000US30091,30091,30,91,"Sheridan County, Montana",3384,51,3333,3276,3201,7,54,14,0,0,57,0.104,0500000US30091,Sheridan County,3539,107,3432,3261,3170,14,61,13,0,3,171,0.194,0.090,0.858,9.0%,85.8%
0500000US30093,30093,30,93,"Silver Bow County, Montana",34200,1253,32947,32401,31515,103,587,161,22,13,546,0.149,0500000US30093,Silver Bow County,35133,1638,33495,32055,31081,126,480,214,20,134,1440,0.213,0.064,0.432,6.4%,43.2%
0500000US30095,30095,30,95,"Stillwater County, Montana",9117,214,8903,8780,8688,9,54,28,1,0,123,0.091,0500000US30095,Stillwater County,8963,269,8694,8263,8110,13,85,22,0,33,431,0.178,0.087,0.953,8.7%,95.3%
0500000US30097,30097,30,97,"Sweet Grass County, Montana",3651,51,3600,3546,3491,4,15,22,1,13,54,0.085,0500000US30097,Sweet Grass County,3678,98,3580,3390,3332,8,24,15,3,8,190,0.176,0.091,1.063,9.1%,106.3%
0500000US30099,30099,30,99,"Teton County, Montana",6073,76,5997,5892,5792,3,86,8,1,2,105,0.090,0500000US30099,Teton County,6226,85,6141,5834,5655,19,101,15,6,38,307,0.172,0.082,0.917,8.2%,91.7%
0500000US30101,30101,30,101,"Toole County, Montana",5324,129,5195,5098,4813,28,233,23,1,0,97,0.180,0500000US30101,Toole County,4971,178,4793,4605,4179,32,338,36,0,20,188,0.286,0.106,0.589,10.6%,58.9%
0500000US30103,30103,30,103,"Treasure County, Montana",718,25,693,677,666,0,6,3,0,2,16,0.138,0500000US30103,Treasure County,762,31,731,708,688,1,15,3,1,0,23,0.182,0.044,0.319,4.4%,31.9%
0500000US30105,30105,30,105,"Valley County, Montana",7369,91,7278,7137,6364,17,715,36,3,2,141,0.244,0500000US30105,Valley County,7578,174,7404,7090,6353,15,674,19,0,29,314,0.287,0.043,0.175,4.3%,17.5%
0500000US30107,30107,30,107,"Wheatland County, Montana",2168,32,2136,2092,2064,7,9,11,0,1,44,0.093,0500000US30107,Wheatland County,2069,68,2001,1874,1850,3,11,3,0,7,127,0.196,0.103,1.104,10.3%,110.4%
0500000US30109,30109,30,109,"Wibaux County, Montana",1017,13,1004,996,987,0,4,5,0,0,8,0.058,0500000US30109,Wibaux County,937,27,910,875,859,2,5,2,2,5,35,0.157,0.099,1.718,9.9%,171.8%
0500000US30111,30111,30,111,"Yellowstone County, Montana",147972,6955,141017,137795,130463,852,5377,915,104,84,3222,0.219,0500000US30111,Yellowstone County,164731,10115,154616,146313,136514,1187,6546,1279,211,576,8303,0.305,0.087,0.396,8.7%,39.6%
0500000US31001,31001,31,1,"Adams County, Nebraska",31364,2544,28820,28545,27747,219,104,436,9,30,275,0.210,0500000US31001,Adams County,31205,3659,27546,26636,25779,247,119,415,9,67,910,0.303,0.092,0.438,9.2%,43.8%
0500000US31003,31003,31,3,"Antelope County, Nebraska",6685,178,6507,6475,6418,19,9,20,0,9,32,0.078,0500000US31003,Antelope County,6295,221,6074,5962,5899,22,16,22,0,3,112,0.120,0.043,0.551,4.3%,55.1%
0500000US31005,31005,31,5,"Arthur County, Nebraska",460,19,441,438,435,0,2,1,0,0,3,0.104,0500000US31005,Arthur County,434,12,422,403,400,3,0,0,0,0,19,0.148,0.044,0.422,4.4%,42.2%
0500000US31007,31007,31,7,"Banner County, Nebraska",690,26,664,659,656,0,3,0,0,0,5,0.095,0500000US31007,Banner County,674,51,623,607,600,0,5,2,0,0,16,0.201,0.107,1.126,10.7%,112.6%
0500000US31009,31009,31,9,"Blaine County, Nebraska",478,0,478,475,474,1,0,0,0,0,3,0.017,0500000US31009,Blaine County,431,11,420,399,397,1,0,1,0,0,21,0.149,0.132,7.934,13.2%,793.4%
0500000US31011,31011,31,11,"Boone County, Nebraska",5505,65,5440,5428,5383,23,11,10,1,0,12,0.044,0500000US31011,Boone County,5379,183,5196,5106,5057,21,15,7,0,6,90,0.115,0.071,1.626,7.1%,162.6%
0500000US31013,31013,31,13,"Box Butte County, Nebraska",11308,1157,10151,9976,9564,49,328,33,1,1,175,0.273,0500000US31013,Box Butte County,10842,1246,9596,9128,8681,66,293,71,0,17,468,0.343,0.070,0.256,7.0%,25.6%
0500000US31015,31015,31,15,"Boyd County, Nebraska",2099,33,2066,2055,2024,1,9,17,0,4,11,0.070,0500000US31015,Boyd County,1810,33,1777,1738,1723,0,11,0,0,4,39,0.093,0.023,0.332,2.3%,33.2%
0500000US31017,31017,31,17,"Brown County, Nebraska",3145,29,3116,3090,3072,2,9,7,0,0,26,0.046,0500000US31017,Brown County,2903,176,2727,2646,2629,2,7,6,0,2,81,0.175,0.130,2.837,13.0%,283.7%
0500000US31019,31019,31,19,"Buffalo County, Nebraska",46102,3432,42670,42224,41128,354,101,587,4,50,446,0.198,0500000US31019,Buffalo County,50084,5062,45022,43644,42108,600,149,660,33,94,1378,0.282,0.084,0.421,8.4%,42.1%
0500000US31021,31021,31,21,"Burt County, Nebraska",6858,126,6732,6668,6520,23,107,17,1,0,64,0.095,0500000US31021,Burt County,6722,172,6550,6349,6197,19,72,35,17,9,201,0.148,0.053,0.555,5.3%,55.5%
0500000US31023,31023,31,23,"Butler County, Nebraska",8395,195,8200,8158,8092,24,10,27,0,5,42,0.070,0500000US31023,Butler County,8369,482,7887,7709,7626,28,22,9,1,23,178,0.166,0.096,1.360,9.6%,136.0%
0500000US31025,31025,31,25,"Cass County, Nebraska",25241,608,24633,24345,24083,82,70,84,12,14,288,0.089,0500000US31025,Cass County,26598,988,25610,24652,24261,102,87,103,8,91,958,0.165,0.076,0.859,7.6%,85.9%
0500000US31027,31027,31,27,"Cedar County, Nebraska",8852,113,8739,8694,8659,7,21,7,0,0,45,0.043,0500000US31027,Cedar County,8380,186,8194,8062,8010,25,13,9,2,3,132,0.086,0.043,0.994,4.3%,99.4%
0500000US31029,31029,31,29,"Chase County, Nebraska",3966,442,3524,3502,3491,5,2,4,0,0,22,0.213,0500000US31029,Chase County,3893,562,3331,3244,3209,20,2,11,0,2,87,0.299,0.086,0.406,8.6%,40.6%
0500000US31031,31031,31,31,"Cherry County, Nebraska",5713,95,5618,5483,5141,11,310,20,1,0,135,0.186,0500000US31031,Cherry County,5455,148,5307,5068,4772,11,271,7,0,7,239,0.230,0.043,0.232,4.3%,23.2%
0500000US31033,31033,31,33,"Cheyenne County, Nebraska",9998,610,9388,9316,9079,19,52,158,5,3,72,0.171,0500000US31033,Cheyenne County,9468,751,8717,8433,8239,51,29,75,0,39,284,0.235,0.064,0.374,6.4%,37.4%
0500000US31035,31035,31,35,"Clay County, Nebraska",6542,502,6040,5994,5941,21,21,10,0,1,46,0.169,0500000US31035,Clay County,6104,523,5581,5417,5372,8,13,10,0,14,164,0.217,0.048,0.284,4.8%,28.4%
0500000US31037,31037,31,37,"Colfax County, Nebraska",10515,4315,6200,6158,6031,49,33,24,4,17,42,0.503,0500000US31037,Colfax County,10582,4993,5589,5487,5018,375,26,50,2,16,102,0.551,0.049,0.097,4.9%,9.7%
0500000US31039,31039,31,39,"Cuming County, Nebraska",9139,754,8385,8320,8271,8,21,17,1,2,65,0.174,0500000US31039,Cuming County,9013,1112,7901,7735,7638,21,26,18,9,23,166,0.266,0.092,0.530,9.2%,53.0%
0500000US31041,31041,31,41,"Custer County, Nebraska",10939,216,10723,10629,10551,28,31,15,0,4,94,0.069,0500000US31041,Custer County,10545,388,10157,9919,9804,48,32,19,2,14,238,0.134,0.065,0.932,6.5%,93.2%
0500000US31043,31043,31,43,"Dakota County, Nebraska",21006,7419,13587,13371,11596,641,466,621,43,4,216,0.568,0500000US31043,Dakota County,21582,8811,12771,12265,9347,1603,526,602,154,33,506,0.638,0.070,0.123,7.0%,12.3%
0500000US31045,31045,31,45,"Dawes County, Nebraska",9182,306,8876,8670,8058,130,341,94,46,1,206,0.227,0500000US31045,Dawes County,8199,328,7871,7509,6943,164,322,53,6,21,362,0.277,0.051,0.224,5.1%,22.4%
0500000US31047,31047,31,47,"Dawson County, Nebraska",24326,7746,16580,16443,15464,710,74,135,39,21,137,0.494,0500000US31047,Dawson County,24111,8643,15468,15053,13529,1187,44,192,41,60,415,0.554,0.060,0.122,6.0%,12.2%
0500000US31049,31049,31,49,"Deuel County, Nebraska",1941,75,1866,1851,1839,1,6,5,0,0,15,0.101,0500000US31049,Deuel County,1838,100,1738,1707,1686,1,7,6,0,7,31,0.155,0.055,0.541,5.5%,54.1%
0500000US31051,31051,31,51,"Dixon County, Nebraska",6000,622,5378,5346,5293,14,23,10,2,4,32,0.211,0500000US31051,Dixon County,5606,796,4810,4704,4643,17,19,17,0,8,106,0.294,0.083,0.391,8.3%,39.1%
0500000US31053,31053,31,53,"Dodge County, Nebraska",36691,3689,33002,32673,32120,183,127,180,31,32,329,0.223,0500000US31053,Dodge County,37167,6083,31084,30137,29501,215,133,183,12,93,947,0.342,0.119,0.533,11.9%,53.3%
0500000US31055,31055,31,55,"Douglas County, Nebraska",517110,57804,459306,448594,372029,59176,2532,13613,314,930,10712,0.456,0500000US31055,Douglas County,584526,80820,503706,478099,381427,63706,2653,27593,410,2310,25607,0.539,0.083,0.183,8.3%,18.3%
0500000US31057,31057,31,57,"Dundy County, Nebraska",2008,117,1891,1871,1852,7,8,2,2,0,20,0.146,0500000US31057,Dundy County,1654,103,1551,1515,1491,7,9,1,3,4,36,0.183,0.037,0.255,3.7%,25.5%
0500000US31059,31059,31,59,"Fillmore County, Nebraska",5890,178,5712,5683,5619,30,22,9,0,3,29,0.089,0500000US31059,Fillmore County,5551,177,5374,5234,5181,20,19,13,1,0,140,0.127,0.038,0.430,3.8%,43.0%
0500000US31061,31061,31,61,"Franklin County, Nebraska",3225,33,3192,3159,3145,1,10,3,0,0,33,0.049,0500000US31061,Franklin County,2889,82,2807,2768,2741,6,3,14,0,4,39,0.099,0.050,1.026,5.0%,102.6%
0500000US31063,31063,31,63,"Frontier County, Nebraska",2756,35,2721,2700,2687,0,5,4,0,4,21,0.049,0500000US31063,Frontier County,2519,81,2438,2367,2337,17,6,0,3,4,71,0.137,0.088,1.792,8.8%,179.2%
0500000US31065,31065,31,65,"Furnas County, Nebraska",4959,132,4827,4781,4745,8,15,10,2,1,46,0.084,0500000US31065,Furnas County,4636,220,4416,4273,4235,9,19,6,0,4,143,0.162,0.079,0.940,7.9%,94.0%
0500000US31067,31067,31,67,"Gage County, Nebraska",22311,385,21926,21693,21432,72,101,81,3,4,233,0.077,0500000US31067,Gage County,21704,635,21069,20396,20053,122,78,99,1,43,673,0.144,0.068,0.881,6.8%,88.1%
0500000US31069,31069,31,69,"Garden County, Nebraska",2057,80,1977,1956,1942,4,10,0,0,0,21,0.107,0500000US31069,Garden County,1874,88,1786,1741,1722,3,3,2,1,10,45,0.153,0.046,0.428,4.6%,42.8%
0500000US31071,31071,31,71,"Garfield County, Nebraska",2049,15,2034,2029,2022,3,0,2,0,2,5,0.026,0500000US31071,Garfield County,1813,24,1789,1756,1752,3,0,0,0,1,33,0.066,0.040,1.514,4.0%,151.4%
0500000US31073,31073,31,73,"Gosper County, Nebraska",2044,49,1995,1969,1954,8,2,4,0,1,26,0.085,0500000US31073,Gosper County,1893,95,1798,1763,1746,2,4,11,0,0,35,0.146,0.061,0.715,6.1%,71.5%
0500000US31075,31075,31,75,"Grant County, Nebraska",614,7,607,602,600,0,1,1,0,0,5,0.045,0500000US31075,Grant County,611,12,599,595,576,5,12,1,0,1,4,0.110,0.066,1.460,6.6%,146.0%
0500000US31077,31077,31,77,"Greeley County, Nebraska",2538,51,2487,2475,2451,16,5,2,0,1,12,0.067,0500000US31077,Greeley County,2188,52,2136,2119,2098,1,3,6,1,10,17,0.080,0.013,0.194,1.3%,19.4%
0500000US31079,31079,31,79,"Hall County, Nebraska",58607,13653,44954,44382,42537,906,231,579,34,95,572,0.418,0500000US31079,Hall County,62895,19181,43714,42350,39420,1815,215,688,25,187,1364,0.513,0.094,0.225,9.4%,22.5%
0500000US31081,31081,31,81,"Hamilton County, Nebraska",9124,181,8943,8894,8839,19,12,18,1,5,49,0.061,0500000US31081,Hamilton County,9429,320,9109,8886,8796,27,30,14,0,19,223,0.128,0.067,1.097,6.7%,109.7%
0500000US31083,31083,31,83,"Harlan County, Nebraska",3423,45,3378,3363,3343,1,11,7,0,1,15,0.046,0500000US31083,Harlan County,3073,90,2983,2924,2907,1,5,11,0,0,59,0.104,0.058,1.259,5.8%,125.9%
0500000US31085,31085,31,85,"Hayes County, Nebraska",967,33,934,933,928,0,1,3,1,0,1,0.078,0500000US31085,Hayes County,856,63,793,766,760,0,4,2,0,0,27,0.205,0.127,1.637,12.7%,163.7%
0500000US31087,31087,31,87,"Hitchcock County, Nebraska",2908,42,2866,2842,2820,6,12,3,0,1,24,0.059,0500000US31087,Hitchcock County,2616,87,2529,2469,2462,0,0,2,4,1,60,0.113,0.053,0.899,5.3%,89.9%
0500000US31089,31089,31,89,"Holt County, Nebraska",10435,305,10130,10089,10021,16,28,16,3,5,41,0.077,0500000US31089,Holt County,10127,521,9606,9467,9325,41,38,50,1,12,139,0.149,0.072,0.941,7.2%,94.1%
0500000US31091,31091,31,91,"Hooker County, Nebraska",736,8,728,725,721,0,4,0,0,0,3,0.040,0500000US31091,Hooker County,711,11,700,669,663,4,1,1,0,0,31,0.128,0.088,2.193,8.8%,219.3%
0500000US31093,31093,31,93,"Howard County, Nebraska",6274,109,6165,6113,6067,15,16,12,2,1,52,0.065,0500000US31093,Howard County,6475,146,6329,6202,6154,13,14,12,1,8,127,0.096,0.031,0.485,3.1%,48.5%
0500000US31095,31095,31,95,"Jefferson County, Nebraska",7547,200,7347,7286,7225,17,24,18,2,0,61,0.083,0500000US31095,Jefferson County,7240,361,6879,6653,6558,20,40,15,0,20,226,0.176,0.093,1.128,9.3%,112.8%
0500000US31097,31097,31,97,"Johnson County, Nebraska",5217,435,4782,4763,4355,278,58,71,0,1,19,0.293,0500000US31097,Johnson County,5290,629,4661,4548,4101,311,52,76,0,8,113,0.381,0.088,0.299,8.8%,29.9%
0500000US31099,31099,31,99,"Kearney County, Nebraska",6489,244,6245,6207,6162,10,14,11,3,7,38,0.097,0500000US31099,Kearney County,6688,385,6303,6106,6064,3,14,12,2,11,197,0.174,0.077,0.795,7.7%,79.5%
0500000US31101,31101,31,101,"Keith County, Nebraska",8368,474,7894,7802,7728,16,25,33,0,0,92,0.144,0500000US31101,Keith County,8335,750,7585,7327,7232,15,19,38,7,16,258,0.238,0.094,0.656,9.4%,65.6%
0500000US31103,31103,31,103,"Keya Paha County, Nebraska",824,4,820,817,815,0,1,1,0,0,3,0.022,0500000US31103,Keya Paha County,769,20,749,735,734,0,1,0,0,0,14,0.088,0.066,3.056,6.6%,305.6%
0500000US31105,31105,31,105,"Kimball County, Nebraska",3821,244,3577,3527,3461,6,29,27,2,2,50,0.175,0500000US31105,Kimball County,3434,262,3172,3075,3026,1,24,15,0,9,97,0.217,0.042,0.238,4.2%,23.8%
0500000US31107,31107,31,107,"Knox County, Nebraska",8701,155,8546,8437,7688,8,722,17,0,2,109,0.212,0500000US31107,Knox County,8391,185,8206,7970,6967,16,943,28,3,13,236,0.297,0.085,0.400,8.5%,40.0%
0500000US31109,31109,31,109,"Lancaster County, Nebraska",285407,16685,268722,262417,240702,9636,1674,9895,131,379,6305,0.282,0500000US31109,Lancaster County,322608,25844,296764,282534,251962,13369,1707,13975,170,1351,14230,0.378,0.096,0.338,9.6%,33.8%
0500000US31111,31111,31,111,"Lincoln County, Nebraska",36288,2602,33686,33354,32741,235,162,192,5,19,332,0.181,0500000US31111,Lincoln County,34676,3011,31665,30614,29643,382,147,325,6,111,1051,0.261,0.080,0.442,8.0%,44.2%
0500000US31113,31113,31,113,"Logan County, Nebraska",763,13,750,748,739,1,7,1,0,0,2,0.062,0500000US31113,Logan County,716,23,693,669,665,0,0,4,0,0,24,0.135,0.074,1.197,7.4%,119.7%
0500000US31115,31115,31,115,"Loup County, Nebraska",632,13,619,619,617,1,1,0,0,0,0,0.046,0500000US31115,Loup County,607,18,589,566,565,0,0,1,0,0,23,0.131,0.085,1.825,8.5%,182.5%
0500000US31117,31117,31,117,"McPherson County, Nebraska",539,2,537,530,528,2,0,0,0,0,7,0.040,0500000US31117,McPherson County,399,3,396,385,378,0,4,2,0,1,11,0.102,0.061,1.526,6.1%,152.6%
0500000US31119,31119,31,119,"Madison County, Nebraska",34876,4504,30372,29992,29062,409,337,157,10,17,380,0.289,0500000US31119,Madison County,35585,5514,30071,29163,27823,404,366,445,7,118,908,0.364,0.075,0.260,7.5%,26.0%
0500000US31121,31121,31,121,"Merrick County, Nebraska",7845,271,7574,7514,7405,14,30,59,6,0,60,0.108,0500000US31121,Merrick County,7668,372,7296,7039,6941,41,25,29,3,0,257,0.177,0.069,0.644,6.9%,64.4%
0500000US31123,31123,31,123,"Morrill County, Nebraska",5042,687,4355,4320,4256,8,35,18,0,3,35,0.269,0500000US31123,Morrill County,4555,648,3907,3810,3722,19,38,20,0,11,97,0.312,0.043,0.159,4.3%,15.9%
0500000US31125,31125,31,125,"Nance County, Nebraska",3735,65,3670,3646,3627,8,9,2,0,0,24,0.057,0500000US31125,Nance County,3380,60,3320,3220,3202,4,8,5,0,1,100,0.101,0.045,0.789,4.5%,78.9%
0500000US31127,31127,31,127,"Nemaha County, Nebraska",7248,133,7115,7054,6939,62,18,30,2,3,61,0.083,0500000US31127,Nemaha County,7074,208,6866,6665,6538,56,27,31,0,13,201,0.144,0.061,0.736,6.1%,73.6%
0500000US31129,31129,31,129,"Nuckolls County, Nebraska",4500,97,4403,4356,4333,6,8,9,0,0,47,0.072,0500000US31129,Nuckolls County,4095,118,3977,3860,3835,4,4,3,0,14,117,0.121,0.049,0.678,4.9%,67.8%
0500000US31131,31131,31,131,"Otoe County, Nebraska",15740,902,14838,14711,14499,68,45,68,16,15,127,0.148,0500000US31131,Otoe County,15912,1262,14650,14106,13867,82,36,86,0,35,544,0.233,0.085,0.574,8.5%,57.4%
0500000US31133,31133,31,133,"Pawnee County, Nebraska",2773,35,2738,2705,2683,9,4,8,0,1,33,0.064,0500000US31133,Pawnee County,2544,39,2505,2461,2446,4,7,0,1,3,44,0.075,0.011,0.181,1.1%,18.1%
0500000US31135,31135,31,135,"Perkins County, Nebraska",2970,95,2875,2867,2848,10,3,5,0,1,8,0.079,0500000US31135,Perkins County,2858,146,2712,2641,2620,10,3,3,3,2,71,0.156,0.077,0.969,7.7%,96.9%
0500000US31137,31137,31,137,"Phelps County, Nebraska",9188,373,8815,8751,8694,12,21,21,3,0,64,0.103,0500000US31137,Phelps County,8968,551,8417,8247,8140,34,20,28,1,24,170,0.172,0.069,0.671,6.9%,67.1%
0500000US31139,31139,31,139,"Pierce County, Nebraska",7266,93,7173,7139,7098,11,15,12,0,3,34,0.046,0500000US31139,Pierce County,7317,142,7175,7025,6950,30,17,12,2,14,150,0.097,0.051,1.131,5.1%,113.1%
0500000US31141,31141,31,141,"Platte County, Nebraska",32237,4452,27785,27584,27167,128,97,149,6,37,201,0.271,0500000US31141,Platte County,34296,7252,27044,26335,25583,346,98,198,9,101,709,0.398,0.128,0.472,12.8%,47.2%
0500000US31143,31143,31,143,"Polk County, Nebraska",5406,156,5250,5210,5186,6,10,6,2,0,40,0.079,0500000US31143,Polk County,5214,259,4955,4786,4751,8,14,2,1,10,169,0.166,0.087,1.108,8.7%,110.8%
0500000US31145,31145,31,145,"Red Willow County, Nebraska",11055,462,10593,10505,10345,81,43,28,1,7,88,0.122,0500000US31145,Red Willow County,10702,687,10015,9750,9536,112,37,39,12,14,265,0.201,0.079,0.643,7.9%,64.3%
0500000US31147,31147,31,147,"Richardson County, Nebraska",8363,112,8251,8111,7830,11,242,27,1,0,140,0.122,0500000US31147,Richardson County,7871,155,7716,7380,7096,15,223,35,0,11,336,0.184,0.062,0.509,6.2%,50.9%
0500000US31149,31149,31,149,"Rock County, Nebraska",1526,2,1524,1519,1502,1,9,3,0,4,5,0.031,0500000US31149,Rock County,1262,20,1242,1225,1219,3,1,0,0,2,17,0.067,0.035,1.136,3.5%,113.6%
0500000US31151,31151,31,151,"Saline County, Nebraska",14200,2870,11330,11202,10817,92,40,223,2,28,128,0.378,0500000US31151,Saline County,14292,4067,10225,9882,9363,130,41,277,46,25,343,0.489,0.110,0.291,11.0%,29.1%
0500000US31153,31153,31,153,"Sarpy County, Nebraska",158840,11569,147271,143499,133132,6119,554,3313,157,224,3772,0.290,0500000US31153,Sarpy County,190604,20055,170549,160515,147064,7232,553,4726,224,716,10034,0.389,0.099,0.342,9.9%,34.2%
0500000US31155,31155,31,155,"Saunders County, Nebraska",20780,415,20365,20191,19992,69,43,83,1,3,174,0.074,0500000US31155,Saunders County,22278,585,21693,21014,20703,72,77,86,5,71,679,0.135,0.061,0.823,6.1%,82.3%
0500000US31157,31157,31,157,"Scotts Bluff County, Nebraska",36970,7785,29185,28873,27931,157,533,207,15,30,312,0.385,0500000US31157,Scotts Bluff County,36084,8203,27881,26813,25711,234,466,277,25,100,1068,0.439,0.055,0.143,5.5%,14.3%
0500000US31159,31159,31,159,"Seward County, Nebraska",16750,272,16478,16338,16152,59,49,71,2,5,140,0.070,0500000US31159,Seward County,17609,496,17113,16635,16382,102,44,57,6,44,478,0.133,0.063,0.905,6.3%,90.5%
0500000US31161,31161,31,161,"Sheridan County, Nebraska",5469,171,5298,5153,4559,12,562,18,2,0,145,0.293,0500000US31161,Sheridan County,5127,222,4905,4673,4095,15,522,29,2,10,232,0.348,0.055,0.187,5.5%,18.7%
0500000US31163,31163,31,163,"Sherman County, Nebraska",3152,31,3121,3110,3095,3,2,9,0,1,11,0.036,0500000US31163,Sherman County,2959,82,2877,2798,2774,0,16,5,2,1,79,0.120,0.084,2.349,8.4%,234.9%
0500000US31165,31165,31,165,"Sioux County, Nebraska",1311,52,1259,1244,1240,1,2,1,0,0,15,0.104,0500000US31165,Sioux County,1135,43,1092,1067,1055,0,2,4,2,4,25,0.134,0.030,0.293,3.0%,29.3%
0500000US31167,31167,31,167,"Stanton County, Nebraska",6129,281,5848,5801,5729,36,25,6,0,5,47,0.124,0500000US31167,Stanton County,5842,352,5490,5300,5215,22,27,18,7,11,190,0.198,0.074,0.599,7.4%,59.9%
0500000US31169,31169,31,169,"Thayer County, Nebraska",5228,76,5152,5110,5077,10,8,15,0,0,42,0.057,0500000US31169,Thayer County,5034,136,4898,4806,4769,10,9,10,5,3,92,0.101,0.045,0.791,4.5%,79.1%
0500000US31171,31171,31,171,"Thomas County, Nebraska",647,12,635,633,629,1,1,2,0,0,2,0.054,0500000US31171,Thomas County,669,29,640,626,623,0,3,0,0,0,14,0.130,0.076,1.394,7.6%,139.4%
0500000US31173,31173,31,173,"Thurston County, Nebraska",6940,190,6750,6654,2739,17,3890,6,2,0,96,0.529,0500000US31173,Thurston County,6773,260,6513,6393,2444,24,3897,8,4,16,120,0.537,0.008,0.015,0.8%,1.5%
0500000US31175,31175,31,175,"Valley County, Nebraska",4260,79,4181,4151,4129,3,5,13,0,1,30,0.060,0500000US31175,Valley County,4059,116,3943,3858,3818,15,4,5,5,11,85,0.114,0.054,0.894,5.4%,89.4%
0500000US31177,31177,31,177,"Washington County, Nebraska",20234,419,19815,19653,19405,120,40,54,7,27,162,0.080,0500000US31177,Washington County,20865,619,20246,19597,19359,70,25,100,1,42,649,0.137,0.058,0.722,5.8%,72.2%
0500000US31179,31179,31,179,"Wayne County, Nebraska",9595,401,9194,9117,8893,127,26,48,12,11,77,0.139,0500000US31179,Wayne County,9697,991,8706,8397,7828,350,28,122,8,61,309,0.335,0.196,1.414,19.6%,141.4%
0500000US31181,31181,31,181,"Webster County, Nebraska",3812,133,3679,3635,3588,18,8,11,10,0,44,0.113,0500000US31181,Webster County,3395,148,3247,3150,3111,14,14,9,0,2,97,0.158,0.045,0.398,4.5%,39.8%
0500000US31183,31183,31,183,"Wheeler County, Nebraska",818,6,812,807,802,0,1,4,0,0,5,0.039,0500000US31183,Wheeler County,774,20,754,739,736,0,2,0,0,1,15,0.095,0.056,1.453,5.6%,145.3%
0500000US31185,31185,31,185,"York County, Nebraska",13665,555,13110,13009,12725,149,48,59,4,24,101,0.131,0500000US31185,York County,14125,839,13286,12919,12559,167,71,90,2,30,367,0.205,0.074,0.565,7.4%,56.5%
0500000US32001,32001,32,1,"Churchill County, Nevada",24877,3009,21868,21086,19030,366,991,633,41,25,782,0.397,0500000US32001,Churchill County,25516,3586,21930,20174,17870,428,1006,640,87,143,1756,0.483,0.086,0.216,8.6%,21.6%
0500000US32003,32003,32,3,"Clark County, Nevada",1951269,568644,1382625,1320822,935955,194821,8732,165121,12474,3719,61803,0.667,0500000US32003,Clark County,2265461,701416,1564045,1440030,892802,275002,8487,231972,18877,12890,124015,0.720,0.054,0.081,5.4%,8.1%
0500000US32005,32005,32,5,"Douglas County, Nevada",46997,5103,41894,40850,39094,174,759,699,60,64,1044,0.295,0500000US32005,Douglas County,49488,6141,43347,41065,38856,183,807,898,81,240,2282,0.365,0.070,0.237,7.0%,23.7%
0500000US32007,32007,32,7,"Elko County, Nevada",48818,11158,37660,36873,33730,329,2286,434,62,32,787,0.468,0500000US32007,Elko County,53702,13592,40110,37936,34177,494,2378,555,85,247,2174,0.527,0.059,0.127,5.9%,12.7%
0500000US32009,32009,32,9,"Esmeralda County, Nevada",783,120,663,642,605,0,33,3,0,1,21,0.377,0500000US32009,Esmeralda County,729,139,590,549,521,4,20,4,0,0,41,0.449,0.072,0.191,7.2%,19.1%
0500000US32011,32011,32,11,"Eureka County, Nevada",1987,238,1749,1725,1662,2,42,18,0,1,24,0.285,0500000US32011,Eureka County,1855,178,1677,1586,1545,2,21,4,3,11,91,0.295,0.009,0.032,0.9%,3.2%
0500000US32013,32013,32,13,"Humboldt County, Nevada",16528,4038,12490,12239,11395,78,628,108,18,12,251,0.463,0500000US32013,Humboldt County,17285,4511,12774,12117,11032,137,571,152,26,199,657,0.522,0.058,0.126,5.8%,12.6%
0500000US32015,32015,32,15,"Lander County, Nevada",5775,1219,4556,4494,4259,17,197,20,1,0,62,0.410,0500000US32015,Lander County,5734,1256,4478,4244,3975,7,206,27,10,19,234,0.468,0.058,0.142,5.8%,14.2%
0500000US32017,32017,32,17,"Lincoln County, Nevada",5345,332,5013,4927,4698,120,57,38,14,0,86,0.223,0500000US32017,Lincoln County,4499,294,4205,4075,3838,168,26,21,13,9,130,0.266,0.043,0.193,4.3%,19.3%
0500000US32019,32019,32,19,"Lyon County, Nevada",51980,7674,44306,42962,40634,363,1061,701,124,79,1344,0.366,0500000US32019,Lyon County,59235,10339,48896,45265,42350,488,1083,924,168,252,3631,0.454,0.088,0.241,8.8%,24.1%
0500000US32021,32021,32,21,"Mineral County, Nevada",4772,436,4336,4176,3271,182,666,49,6,2,160,0.500,0500000US32021,Mineral County,4554,508,4046,3818,2858,161,711,64,8,16,228,0.565,0.066,0.132,6.6%,13.2%
0500000US32023,32023,32,23,"Nye County, Nevada",43946,5967,37979,36870,34663,836,592,547,179,53,1109,0.358,0500000US32023,Nye County,51591,7927,43664,40965,37313,1496,620,1028,217,291,2699,0.449,0.091,0.254,9.1%,25.4%
0500000US32027,32027,32,27,"Pershing County, Nevada",6753,1508,5245,5127,4605,251,173,87,7,4,118,0.483,0500000US32027,Pershing County,6650,1499,5151,4855,4197,322,198,109,8,21,296,0.545,0.063,0.130,6.3%,13.0%
0500000US32029,32029,32,29,"Storey County, Nevada",4010,228,3782,3709,3532,40,57,66,12,2,73,0.220,0500000US32029,Storey County,4104,340,3764,3509,3338,24,38,67,8,34,255,0.327,0.107,0.487,10.7%,48.7%
0500000US32031,32031,32,31,"Washoe County, Nevada",421407,93724,327683,317402,278213,9088,5782,21288,2358,673,10281,0.511,0500000US32031,Washoe County,486492,122204,364288,338977,287862,11527,5790,28063,3250,2485,25311,0.580,0.069,0.135,6.9%,13.5%
0500000US32033,32033,32,33,"White Pine County, Nevada",10030,1326,8704,8535,7652,388,384,96,9,6,169,0.397,0500000US32033,White Pine County,9080,1457,7623,7296,6354,438,358,105,19,22,327,0.479,0.082,0.207,8.2%,20.7%
0500000US32510,32510,32,510,"Carson City, Nevada",55274,11777,43497,42479,39083,1003,1096,1139,91,67,1018,0.453,0500000US32510,Carson City,58639,14870,43769,40975,37064,1079,1072,1358,110,292,2794,0.533,0.080,0.175,8.0%,17.5%
0500000US33001,33001,33,1,"Belknap County, New Hampshire",60088,724,59364,58667,57553,261,119,695,9,30,697,0.082,0500000US33001,Belknap County,63705,1261,62444,59941,58714,324,122,582,11,188,2503,0.148,0.066,0.807,6.6%,80.7%
0500000US33003,33003,33,3,"Carroll County, New Hampshire",47818,473,47345,46862,46285,126,122,297,7,25,483,0.063,0500000US33003,Carroll County,50107,769,49338,47748,46947,131,100,358,6,206,1590,0.121,0.058,0.923,5.8%,92.3%
0500000US33005,33005,33,5,"Cheshire County, New Hampshire",77117,1090,76027,75061,73537,363,171,910,19,61,966,0.090,0500000US33005,Cheshire County,76458,1802,74656,71476,69264,648,146,1067,46,305,3180,0.177,0.087,0.960,8.7%,96.0%
0500000US33007,33007,33,7,"Coos County, New Hampshire",33055,401,32654,32237,31801,141,107,165,1,22,417,0.074,0500000US33007,Coos County,31268,672,30596,29474,28629,494,84,193,3,71,1122,0.160,0.086,1.155,8.6%,115.5%
0500000US33009,33009,33,9,"Grafton County, New Hampshire",89118,1600,87518,86103,82294,768,307,2618,16,100,1415,0.146,0500000US33009,Grafton County,91118,2579,88539,84580,80370,783,180,2855,24,368,3959,0.218,0.072,0.497,7.2%,49.7%
0500000US33011,33011,33,11,"Hillsborough County, New Hampshire",400721,21241,379480,373343,351224,7405,742,12898,99,975,6137,0.227,0500000US33011,Hillsborough County,422937,33498,389439,372234,342652,10044,630,16413,112,2383,17205,0.334,0.106,0.467,10.6%,46.7%
0500000US33013,33013,33,13,"Merrimack County, New Hampshire",146445,2339,144106,142306,138048,1452,355,2307,40,104,1800,0.111,0500000US33013,Merrimack County,153808,3880,149928,143745,137252,2536,310,3013,59,575,6183,0.201,0.090,0.815,9.0%,81.5%
0500000US33015,33015,33,15,"Rockingham County, New Hampshire",295223,6142,289081,285570,278011,1790,418,4910,93,348,3511,0.112,0500000US33015,Rockingham County,314176,10257,303919,293079,283099,2076,342,6247,79,1236,10840,0.185,0.073,0.650,7.3%,65.0%
0500000US33017,33017,33,17,"Strafford County, New Hampshire",123143,2201,120942,118908,114210,1144,234,3171,41,108,2034,0.138,0500000US33017,Strafford County,130889,3914,126975,121202,114599,1434,251,4473,42,403,5773,0.229,0.091,0.656,9.1%,65.6%
0500000US33019,33019,33,19,"Sullivan County, New Hampshire",43742,493,43249,42684,42087,175,118,270,4,30,565,0.074,0500000US33019,Sullivan County,43063,822,42241,40032,39123,185,134,403,6,181,2209,0.171,0.098,1.321,9.8%,132.1%
0500000US34001,34001,34,1,"Atlantic County, New Jersey",274549,46241,228308,223183,160871,40882,488,20419,60,463,5125,0.600,0500000US34001,Atlantic County,274534,53713,220821,211225,148858,39022,357,21563,82,1343,9596,0.640,0.040,0.066,4.0%,6.6%
0500000US34003,34003,34,3,"Bergen County, New Jersey",905116,145281,759835,747004,566053,46850,869,130491,173,2568,12831,0.559,0500000US34003,Bergen County,955732,204683,751049,726733,511919,49909,811,157500,130,6464,24316,0.637,0.077,0.138,7.7%,13.8%
0500000US34005,34005,34,5,"Burlington County, New Jersey",448734,28831,419903,409781,317021,71247,656,19193,193,1471,10122,0.469,0500000US34005,Burlington County,461860,40387,421473,399406,294510,74807,609,25980,265,3235,22067,0.554,0.085,0.181,8.5%,18.1%
0500000US34007,34007,34,7,"Camden County, New Jersey",513657,73124,440533,432149,309648,94762,859,26043,106,731,8384,0.579,0500000US34007,Camden County,523485,95255,428230,410104,279274,95135,692,32328,99,2576,18126,0.644,0.065,0.112,6.5%,11.2%
0500000US34009,34009,34,9,"Cape May County, New Jersey",97265,6054,91211,89844,84522,4244,143,818,32,85,1367,0.239,0500000US34009,Cape May County,95263,7465,87798,84678,80040,3305,99,893,22,319,3120,0.286,0.047,0.196,4.7%,19.6%
0500000US34011,34011,34,11,"Cumberland County, New Jersey",156898,42457,114441,111510,78931,29376,1102,1854,31,216,2931,0.638,0500000US34011,Cumberland County,154152,53054,101098,95746,65808,26375,905,2051,12,595,5352,0.669,0.030,0.048,3.0%,4.8%
0500000US34013,34013,34,13,"Essex County, New Jersey",783969,159117,624852,611634,260177,308358,1509,35292,177,6121,13218,0.692,0500000US34013,Essex County,863728,210353,653375,619648,235125,324081,1238,46957,169,12078,33727,0.721,0.030,0.043,3.0%,4.3%
0500000US34015,34015,34,15,"Gloucester County, New Jersey",288288,13712,274576,269868,233695,27906,361,7534,62,310,4708,0.330,0500000US34015,Gloucester County,302294,22135,280159,267855,225355,31517,331,9475,74,1103,12304,0.425,0.095,0.288,9.5%,28.8%
0500000US34017,34017,34,17,"Hudson County, New Jersey",634266,267853,366413,356012,195510,71315,935,83825,176,4251,10401,0.696,0500000US34017,Hudson County,724854,293019,431835,411851,206530,71385,1069,123424,233,9210,19984,0.716,0.020,0.028,2.0%,2.8%
0500000US34019,34019,34,19,"Hunterdon County, New Jersey",128349,6722,121627,120285,112607,3233,97,4155,27,166,1342,0.226,0500000US34019,Hunterdon County,128947,10929,118018,114009,104667,3030,92,5677,8,535,4009,0.330,0.105,0.464,10.5%,46.4%
0500000US34021,34021,34,21,"Mercer County, New Jersey",366513,55318,311195,305143,199909,71378,535,32545,146,630,6052,0.634,0500000US34021,Mercer County,387340,84177,303163,291686,168580,72364,427,48330,106,1879,11477,0.712,0.078,0.124,7.8%,12.4%
0500000US34023,34023,34,23,"Middlesex County, New Jersey",809858,148975,660883,646884,398724,71557,1193,172534,156,2720,13999,0.670,0500000US34023,Middlesex County,863162,193687,669475,648278,333158,78719,1183,227973,192,7053,21197,0.722,0.052,0.077,5.2%,7.7%
0500000US34025,34025,34,25,"Monmouth County, New Jersey",630380,60939,569441,560902,483435,43931,616,31018,172,1730,8539,0.395,0500000US34025,Monmouth County,643615,80730,562885,541156,460825,39178,482,36008,97,4566,21729,0.464,0.069,0.173,6.9%,17.3%
0500000US34027,34027,34,27,"Morris County, New Jersey",492276,56482,435794,428792,369551,14134,369,43862,70,806,7002,0.414,0500000US34027,Morris County,509285,76661,432624,417264,341175,15586,373,57700,93,2337,15360,0.514,0.100,0.240,10.0%,24.0%
0500000US34029,34029,34,29,"Ocean County, New Jersey",576567,47783,528784,523145,495534,16583,454,9924,92,558,5639,0.253,0500000US34029,Ocean County,637229,66329,570900,554099,520578,17649,523,11339,111,3899,16801,0.320,0.067,0.263,6.7%,26.3%
0500000US34031,34031,34,31,"Passaic County, New Jersey",501226,185677,315549,309370,227144,55480,769,24556,53,1368,6179,0.643,0500000US34031,Passaic County,524118,224030,300088,289864,203542,51859,688,30209,52,3514,10224,0.653,0.010,0.016,1.0%,1.6%
0500000US34033,34033,34,33,"Salem County, New Jersey",66083,4507,61576,60468,50736,8940,187,548,10,47,1108,0.387,0500000US34033,Salem County,64837,6535,58302,55449,45279,9049,182,649,13,277,2853,0.481,0.093,0.241,9.3%,24.1%
0500000US34035,34035,34,35,"Somerset County, New Jersey",323444,42091,281353,275945,201849,27480,285,45473,72,786,5408,0.566,0500000US34035,Somerset County,345361,57379,287982,277379,177411,30480,306,67098,69,2015,10603,0.662,0.096,0.169,9.6%,16.9%
0500000US34037,34037,34,37,"Sussex County, New Jersey",149265,9617,139648,137877,132484,2448,147,2605,29,164,1771,0.207,0500000US34037,Sussex County,144221,14310,129911,124891,118247,2858,191,2918,11,666,5020,0.316,0.109,0.523,10.9%,52.3%
0500000US34039,34039,34,39,"Union County, New Jersey",536499,146704,389795,382445,243312,111705,546,24496,107,2279,7350,0.674,0500000US34039,Union County,575345,195519,379826,362289,211245,112261,552,31963,78,6190,17537,0.708,0.034,0.050,3.4%,5.0%
0500000US34041,34041,34,41,"Warren County, New Jersey",108692,7659,101033,99665,93165,3592,107,2642,19,140,1368,0.258,0500000US34041,Warren County,109632,12225,97407,93338,84255,5573,96,2886,28,500,4069,0.392,0.134,0.517,13.4%,51.7%
0500000US35001,35001,35,1,"Bernalillo County, New Mexico",662564,317089,345475,333963,274862,16293,26258,14631,469,1450,11512,0.596,0500000US35001,Bernalillo County,676444,329481,346963,325149,253355,17871,30628,19226,564,3505,21814,0.618,0.022,0.037,2.2%,3.7%
0500000US35003,35003,35,3,"Catron County, New Mexico",3725,709,3016,2949,2832,15,87,5,0,10,67,0.385,0500000US35003,Catron County,3579,602,2977,2865,2738,35,47,8,0,37,112,0.385,0.000,0.001,0.0%,0.1%
0500000US35005,35005,35,5,"Chaves County, New Mexico",65645,34139,31506,30860,28801,1079,458,373,29,120,646,0.537,0500000US35005,Chaves County,65157,37097,28060,26701,24445,947,411,611,29,258,1359,0.534,-0.002,-0.004,-0.2%,-0.4%
0500000US35006,35006,35,6,"Cibola County, New Mexico",27213,9934,17279,16934,5857,221,10680,136,19,21,345,0.666,0500000US35006,Cibola County,27172,8644,18528,17963,5538,254,11767,201,7,196,565,0.669,0.003,0.004,0.3%,0.4%
0500000US35007,35007,35,7,"Colfax County, New Mexico",13750,6488,7262,7106,6863,39,130,48,6,20,156,0.528,0500000US35007,Colfax County,12387,5878,6509,6197,5954,25,108,60,11,39,312,0.543,0.015,0.029,1.5%,2.9%
0500000US35009,35009,35,9,"Curry County, New Mexico",48376,19117,29259,28278,24545,2774,288,574,28,69,981,0.583,0500000US35009,Curry County,48430,21796,26634,24793,21052,2513,249,733,35,211,1841,0.604,0.022,0.037,2.2%,3.7%
0500000US35011,35011,35,11,"De Baca County, New Mexico",2022,779,1243,1211,1200,2,9,0,0,0,32,0.499,0500000US35011,De Baca County,1698,654,1044,998,983,3,4,4,4,0,46,0.516,0.017,0.033,1.7%,3.3%
0500000US35013,35013,35,13,"Dona Ana County, New Mexico Do√±a Ana County",209233,137514,71719,69824,62992,2825,1521,2029,128,329,1895,0.477,0500000US35013,DoÒa Ana County,219561,147672,71889,67796,59749,3172,1463,2458,115,839,4093,0.473,-0.004,-0.009,-0.4%,-0.9%
0500000US35015,35015,35,15,"Eddy County, New Mexico",53829,23731,30098,29543,28111,589,439,325,16,63,555,0.533,0500000US35015,Eddy County,62314,31307,31007,29473,27139,791,518,578,43,404,1534,0.557,0.024,0.046,2.4%,4.6%
0500000US35017,35017,35,17,"Grant County, New Mexico",29514,14252,15262,14959,14356,185,215,109,22,72,303,0.530,0500000US35017,Grant County,28185,13466,14719,14008,13117,249,265,191,18,168,711,0.554,0.024,0.046,2.4%,4.6%
0500000US35019,35019,35,19,"Guadalupe County, New Mexico",4687,3730,957,927,753,66,46,58,0,4,30,0.340,0500000US35019,Guadalupe County,4452,3436,1016,943,769,64,40,49,0,21,73,0.374,0.033,0.098,3.3%,9.8%
0500000US35021,35021,35,21,"Harding County, New Mexico",695,299,396,395,391,2,2,0,0,0,1,0.498,0500000US35021,Harding County,657,282,375,355,352,2,0,0,0,1,20,0.528,0.029,0.059,2.9%,5.9%
0500000US35023,35023,35,23,"Hidalgo County, New Mexico",4894,2769,2125,2088,2025,17,16,23,2,5,37,0.509,0500000US35023,Hidalgo County,4178,2390,1788,1717,1645,14,14,11,5,28,71,0.517,0.009,0.017,0.9%,1.7%
0500000US35025,35025,35,25,"Lea County, New Mexico",64727,33063,31664,31083,27845,2399,468,302,18,51,581,0.552,0500000US35025,Lea County,74455,45193,29262,27700,23775,2497,477,636,21,294,1562,0.528,-0.025,-0.044,-2.5%,-4.4%
0500000US35027,35027,35,27,"Lincoln County, New Mexico",20497,6110,14387,14177,13600,74,407,67,5,24,210,0.470,0500000US35027,Lincoln County,20269,6496,13773,13119,12339,68,429,138,8,137,654,0.525,0.055,0.116,5.5%,11.6%
0500000US35028,35028,35,28,"Los Alamos County, New Mexico",17950,2646,15304,14996,13689,97,111,1060,8,31,308,0.393,0500000US35028,Los Alamos County,19419,3435,15984,15095,13446,157,116,1223,15,138,889,0.483,0.090,0.230,9.0%,23.0%
0500000US35029,35029,35,29,"Luna County, New Mexico",25095,15423,9672,9477,8997,189,144,112,2,33,195,0.494,0500000US35029,Luna County,25427,16670,8757,8264,7671,228,143,160,12,50,493,0.479,-0.015,-0.030,-1.5%,-3.0%
0500000US35031,35031,35,31,"McKinley County, New Mexico",71492,9473,62019,60713,7384,317,52402,542,17,51,1306,0.434,0500000US35031,McKinley County,72902,8611,64291,62766,5946,323,55401,935,34,127,1525,0.401,-0.033,-0.076,-3.3%,-7.6%
0500000US35033,35033,35,33,"Mora County, New Mexico",4881,3953,928,913,873,10,17,11,1,1,15,0.312,0500000US35033,Mora County,4189,3301,888,820,764,10,22,14,0,10,68,0.345,0.033,0.107,3.3%,10.7%
0500000US35035,35035,35,35,"Otero County, New Mexico",63797,22026,41771,40426,33716,2048,3737,716,131,78,1345,0.596,0500000US35035,Otero County,67839,26152,41687,38926,30931,2299,4173,1001,145,377,2761,0.637,0.040,0.067,4.0%,6.7%
0500000US35037,35037,35,37,"Quay County, New Mexico",9041,3834,5207,5089,4847,82,69,78,4,9,118,0.532,0500000US35037,Quay County,8746,3848,4898,4666,4434,89,57,48,2,36,232,0.549,0.016,0.030,1.6%,3.0%
0500000US35039,35039,35,39,"Rio Arriba County, New Mexico",40246,28703,11543,11256,5148,103,5651,138,7,209,287,0.455,0500000US35039,Rio Arriba County,40363,27159,13204,12662,5945,160,6135,233,5,184,542,0.502,0.047,0.103,4.7%,10.3%
0500000US35041,35041,35,41,"Roosevelt County, New Mexico",19846,7913,11933,11684,11022,296,181,161,3,21,249,0.532,0500000US35041,Roosevelt County,19191,8397,10794,10239,9328,443,163,173,18,114,555,0.571,0.039,0.073,3.9%,7.3%
0500000US35043,35043,35,43,"Sandoval County, New Mexico",131561,46129,85432,83086,62445,2462,16006,1763,135,275,2346,0.636,0500000US35043,Sandoval County,148834,57617,91217,86305,63426,2823,16891,2320,166,679,4912,0.654,0.018,0.028,1.8%,2.8%
0500000US35045,35045,35,45,"San Juan County, New Mexico",130044,24776,105268,102818,55254,617,46321,445,64,117,2450,0.656,0500000US35045,San Juan County,121661,23630,98031,93943,43583,554,48413,872,67,454,4088,0.674,0.018,0.028,1.8%,2.8%
0500000US35047,35047,35,47,"San Miguel County, New Mexico",29393,22583,6810,6595,5781,339,226,175,22,52,215,0.371,0500000US35047,San Miguel County,27201,20490,6711,6255,5447,264,278,132,2,132,456,0.392,0.021,0.057,2.1%,5.7%
0500000US35049,35049,35,49,"Santa Fe County, New Mexico",144170,73015,71155,69472,63291,947,3271,1569,59,335,1683,0.550,0500000US35049,Santa Fe County,154823,74377,80446,76230,67861,1221,3869,2238,72,969,4216,0.575,0.025,0.046,2.5%,4.6%
0500000US35051,35051,35,51,"Sierra County, New Mexico",11988,3352,8636,8444,8205,44,130,49,2,14,192,0.453,0500000US35051,Sierra County,11576,3311,8265,7836,7507,70,106,119,3,31,429,0.496,0.043,0.095,4.3%,9.5%
0500000US35053,35053,35,53,"Socorro County, New Mexico",17866,8664,9202,9005,6711,142,1890,208,4,50,197,0.612,0500000US35053,Socorro County,16595,8353,8242,7806,5361,121,1946,295,8,75,436,0.627,0.015,0.025,1.5%,2.5%
0500000US35055,35055,35,55,"Taos County, New Mexico",32937,18381,14556,14100,11958,104,1747,201,5,85,456,0.554,0500000US35055,Taos County,34489,17430,17059,16140,13706,130,1830,196,4,274,919,0.583,0.029,0.053,2.9%,5.3%
0500000US35057,35057,35,57,"Torrance County, New Mexico",16383,6399,9984,9711,9173,172,274,61,7,24,273,0.533,0500000US35057,Torrance County,15045,6265,8780,8262,7761,121,237,51,2,90,518,0.559,0.026,0.048,2.6%,4.8%
0500000US35059,35059,35,59,"Union County, New Mexico",4549,1805,2744,2701,2549,74,50,22,1,5,43,0.528,0500000US35059,Union County,4079,1596,2483,2381,2234,65,57,6,4,15,102,0.546,0.018,0.034,1.8%,3.4%
0500000US35061,35061,35,61,"Valencia County, New Mexico",76569,44605,31964,31158,27734,839,2117,314,32,122,806,0.528,0500000US35061,Valencia County,76205,45775,30430,28571,24651,747,2353,341,32,447,1859,0.533,0.004,0.008,0.4%,0.8%
0500000US36001,36001,36,1,"Albany County, New York",304204,14917,289287,283158,231152,36396,453,14500,88,569,6129,0.403,0500000US36001,Albany County,314848,21595,293253,278406,210895,40667,494,24363,166,1821,14847,0.522,0.118,0.294,11.8%,29.4%
0500000US36003,36003,36,3,"Allegany County, New York",48946,670,48276,47780,46701,494,97,451,7,30,496,0.089,0500000US36003,Allegany County,46456,965,45491,43824,42327,809,91,373,6,218,1667,0.168,0.079,0.882,7.9%,88.2%
0500000US36005,36005,36,5,"Bronx County, New York",1385108,741413,643695,627733,151209,416695,3460,47335,398,8636,15962,0.610,0500000US36005,Bronx County,1472654,806463,666191,637821,130796,419393,3087,67766,457,16322,28370,0.608,-0.001,-0.002,-0.1%,-0.2%
0500000US36007,36007,36,7,"Broome County, New York",200600,6778,193822,189573,173074,8850,328,7019,60,242,4249,0.251,0500000US36007,Broome County,198683,10285,188398,178398,156173,11547,413,9337,64,864,10000,0.371,0.120,0.480,12.0%,48.0%
0500000US36009,36009,36,9,"Cattaraugus County, New York",80317,1345,78972,77750,73849,966,2361,524,14,36,1222,0.153,0500000US36009,Cattaraugus County,77042,1615,75427,71992,67554,996,2661,560,9,212,3435,0.227,0.074,0.485,7.4%,48.5%
0500000US36011,36011,36,11,"Cayuga County, New York",80026,1896,78130,76884,73098,3009,252,387,26,112,1246,0.163,0500000US36011,Cayuga County,76248,2636,73612,69950,66313,2727,224,379,54,253,3662,0.239,0.075,0.461,7.5%,46.1%
0500000US36013,36013,36,13,"Chautauqua County, New York",134905,8241,126664,124599,120463,2763,576,676,31,90,2065,0.198,0500000US36013,Chautauqua County,127657,11769,115888,110659,106063,2891,497,796,49,363,5229,0.299,0.101,0.508,10.1%,50.8%
0500000US36015,36015,36,15,"Chemung County, New York",88830,2240,86590,84528,77643,5528,206,1041,14,96,2062,0.231,0500000US36015,Chemung County,84148,2938,81210,76435,69559,5009,198,1426,15,228,4775,0.308,0.078,0.336,7.8%,33.6%
0500000US36017,36017,36,17,"Chenango County, New York",50477,929,49548,48973,48265,323,151,200,4,30,575,0.085,0500000US36017,Chenango County,47220,1117,46103,43951,43153,345,93,236,15,109,2152,0.162,0.077,0.903,7.7%,90.3%
0500000US36019,36019,36,19,"Clinton County, New York",82128,2054,80074,79068,74832,2953,266,890,15,112,1006,0.168,0500000US36019,Clinton County,79843,2856,76987,73493,69251,2753,238,957,24,270,3494,0.243,0.076,0.451,7.6%,45.1%
0500000US36021,36021,36,21,"Columbia County, New York",63096,2454,60642,59558,55672,2691,85,998,15,97,1084,0.218,0500000US36021,Columbia County,61570,3542,58028,55073,50795,2421,70,1423,16,348,2955,0.312,0.094,0.432,9.4%,43.2%
0500000US36023,36023,36,23,"Cortland County, New York",49336,1094,48242,47512,46252,705,126,412,3,14,730,0.120,0500000US36023,Cortland County,46809,1658,45151,42971,40801,829,113,1018,6,204,2180,0.236,0.116,0.965,11.6%,96.5%
0500000US36025,36025,36,25,"Delaware County, New York",47980,1560,46420,45899,44706,691,102,363,6,31,521,0.130,0500000US36025,Delaware County,44308,1985,42323,40558,38821,1003,93,480,7,154,1765,0.228,0.098,0.750,9.8%,75.0%
0500000US36027,36027,36,27,"Dutchess County, New York",297488,31267,266221,260807,221812,27395,465,10330,80,725,5414,0.423,0500000US36027,Dutchess County,295911,42224,253687,241666,198495,30126,387,10635,67,1956,12021,0.516,0.093,0.221,9.3%,22.1%
0500000US36029,36029,36,29,"Erie County, New York",919040,41731,877309,864080,714156,119916,5199,23621,165,1023,13229,0.376,0500000US36029,Erie County,954236,59658,894578,862320,678236,129874,4667,46090,199,3254,32258,0.469,0.093,0.246,9.3%,24.6%
0500000US36031,36031,36,31,"Essex County, New York",39370,993,38377,37970,36588,982,99,260,8,33,407,0.135,0500000US36031,Essex County,37381,978,36403,34767,33714,610,74,229,7,133,1636,0.184,0.049,0.361,4.9%,36.1%
0500000US36033,36033,36,33,"Franklin County, New York",51599,1506,50093,49526,42640,2834,3753,215,8,76,567,0.308,0500000US36033,Franklin County,47555,1387,46168,44629,38559,1686,4102,191,0,91,1539,0.332,0.024,0.078,2.4%,7.8%
0500000US36035,36035,36,35,"Fulton County, New York",55531,1263,54268,53581,52110,981,104,320,11,55,687,0.118,0500000US36035,Fulton County,53324,2134,51190,48613,47051,966,89,343,0,164,2577,0.217,0.099,0.834,9.9%,83.4%
0500000US36037,36037,36,37,"Genesee County, New York",60079,1616,58463,57554,54990,1491,661,355,2,55,909,0.161,0500000US36037,Genesee County,58388,2752,55636,53280,50960,1358,361,412,16,173,2356,0.234,0.073,0.456,7.3%,45.6%
0500000US36039,36039,36,39,"Greene County, New York",49221,2419,46802,46085,42857,2606,122,382,15,103,717,0.236,0500000US36039,Greene County,47931,3109,44822,42494,39494,2159,100,500,3,238,2328,0.312,0.076,0.321,7.6%,32.1%
0500000US36041,36041,36,41,"Hamilton County, New York",4836,51,4785,4737,4664,33,11,24,4,1,48,0.070,0500000US36041,Hamilton County,5107,100,5007,4831,4769,30,14,12,1,5,176,0.126,0.057,0.816,5.7%,81.6%
0500000US36043,36043,36,43,"Herkimer County, New York",64519,1040,63479,62836,61690,640,137,325,8,36,643,0.085,0500000US36043,Herkimer County,60139,1530,58609,55955,54653,682,76,359,32,153,2654,0.171,0.086,1.009,8.6%,100.9%
0500000US36045,36045,36,45,"Jefferson County, New York",116229,6143,110086,107515,99682,5475,500,1464,273,121,2571,0.259,0500000US36045,Jefferson County,116721,7990,108731,102473,92755,6271,461,2185,300,501,6258,0.358,0.099,0.382,9.9%,38.2%
0500000US36047,36047,36,47,"Kings County, New York",2504700,496285,2008415,1968405,893306,799066,4638,260129,633,10633,40010,0.721,0500000US36047,Kings County,2736074,516426,2219648,2106478,968427,729696,3964,370776,718,32897,113170,0.748,0.027,0.038,2.7%,3.8%
0500000US36049,36049,36,49,"Lewis County, New York",27087,357,26730,26531,26225,170,44,72,16,4,199,0.062,0500000US36049,Lewis County,26582,460,26122,25213,24942,103,40,65,11,52,909,0.118,0.056,0.894,5.6%,89.4%
0500000US36051,36051,36,51,"Livingston County, New York",65393,1802,63591,62790,60296,1491,158,780,11,54,801,0.148,0500000US36051,Livingston County,61834,2721,59113,56669,54611,1071,125,653,6,203,2444,0.216,0.068,0.458,6.8%,45.8%
0500000US36053,36053,36,53,"Madison County, New York",73442,1316,72126,71282,68916,1260,473,576,11,46,844,0.119,0500000US36053,Madison County,68016,1673,66343,63333,60965,1071,435,664,11,187,3010,0.194,0.075,0.633,7.5%,63.3%
0500000US36055,36055,36,55,"Monroe County, New York",744344,54005,690339,676377,542034,107448,1589,24023,182,1101,13962,0.442,0500000US36055,Monroe County,759443,72745,686698,655616,506153,112710,1320,32294,181,2958,31082,0.521,0.079,0.178,7.9%,17.8%
0500000US36057,36057,36,57,"Montgomery County, New York",50219,5654,44565,43967,42732,712,103,356,11,53,598,0.263,0500000US36057,Montgomery County,49532,7312,42220,40005,38237,987,83,479,9,210,2215,0.380,0.117,0.445,11.7%,44.5%
0500000US36059,36059,36,59,"Nassau County, New York",1339532,195355,1144177,1126488,877309,141305,1379,101558,197,4740,17689,0.533,0500000US36059,Nassau County,1395774,256425,1139349,1103621,779454,147216,1714,163165,292,11780,35728,0.629,0.096,0.180,9.6%,18.0%
0500000US36061,36061,36,61,"New York County, New York",1585873,403577,1182296,1152339,761493,205340,2144,177624,533,5205,29957,0.675,0500000US36061,New York County,1694251,402640,1291611,1228622,793294,199592,1895,219624,882,13335,62989,0.692,0.017,0.025,1.7%,2.5%
0500000US36063,36063,36,63,"Niagara County, New York",216469,4694,211775,207600,188907,14511,2135,1807,55,185,4175,0.233,0500000US36063,Niagara County,212666,7818,204848,195412,173691,16206,2294,2439,45,737,9436,0.324,0.091,0.389,9.1%,38.9%
0500000US36065,36065,36,65,"Oneida County, New York",234878,10819,224059,220250,199254,13682,499,6522,49,244,3809,0.274,0500000US36065,Oneida County,232125,15191,216934,207804,180984,14989,508,10522,72,729,9130,0.380,0.106,0.388,10.6%,38.8%
0500000US36067,36067,36,67,"Onondaga County, New York",467026,18829,448197,437249,370040,48696,3432,14370,120,591,10948,0.358,0500000US36067,Onondaga County,476516,26572,449944,426820,347290,54410,2940,20119,106,1955,23124,0.448,0.090,0.252,9.0%,25.2%
0500000US36069,36069,36,69,"Ontario County, New York",107931,3679,104252,102782,99119,2226,244,1111,16,66,1470,0.155,0500000US36069,Ontario County,112458,6113,106345,101848,97397,2439,197,1374,23,418,4497,0.245,0.090,0.582,9.0%,58.2%
0500000US36071,36071,36,71,"Orange County, New York",372813,67185,305628,298624,254259,33895,908,8685,80,797,7004,0.493,0500000US36071,Orange County,401310,89744,311566,297724,231848,41341,754,11665,104,12012,13842,0.603,0.109,0.222,10.9%,22.2%
0500000US36073,36073,36,73,"Orleans County, New York",42883,1757,41126,40437,37658,2368,199,173,7,32,689,0.224,0500000US36073,Orleans County,40343,2087,38256,36361,34037,1840,177,154,12,141,1895,0.281,0.057,0.256,5.7%,25.6%
0500000US36075,36075,36,75,"Oswego County, New York",122109,2552,119557,118200,116091,862,465,709,14,59,1357,0.095,0500000US36075,Oswego County,117525,3616,113909,108728,105710,1370,457,870,19,302,5181,0.188,0.092,0.967,9.2%,96.7%
0500000US36077,36077,36,77,"Otsego County, New York",62259,1921,60338,59513,57734,958,103,660,16,42,825,0.139,0500000US36077,Otsego County,58524,2392,56132,53788,51490,1189,109,813,7,180,2344,0.222,0.083,0.602,8.3%,60.2%
0500000US36079,36079,36,79,"Putnam County, New York",99710,11661,88049,86894,82709,2047,121,1832,14,171,1155,0.297,0500000US36079,Putnam County,97668,17760,79908,77166,71942,2425,80,2146,12,561,2742,0.422,0.125,0.421,12.5%,42.1%
0500000US36081,36081,36,81,"Queens County, New York",2230722,613750,1616972,1560865,616727,395881,6490,508334,1094,32339,56107,0.764,0500000US36081,Queens County,2405464,667861,1737603,1653491,549358,381375,9576,656583,1110,55489,84112,0.769,0.006,0.008,0.6%,0.8%
0500000US36083,36083,36,83,"Rensselaer County, New York",159429,6080,153349,150165,136555,9592,283,3469,25,241,3184,0.260,0500000US36083,Rensselaer County,161130,9482,151648,143144,124600,11800,310,5711,17,706,8504,0.389,0.129,0.494,12.9%,49.4%
0500000US36085,36085,36,85,"Richmond County, New York",468730,81051,387679,381039,300169,44313,695,34697,137,1028,6640,0.545,0500000US36085,Richmond County,495747,96960,398787,387469,277981,46835,624,58753,135,3141,11318,0.624,0.078,0.144,7.8%,14.4%
0500000US36087,36087,36,87,"Rockland County, New York",311687,48783,262904,258531,203670,34623,487,19099,43,609,4373,0.532,0500000US36087,Rockland County,338329,66451,271878,264178,206113,33775,390,20413,42,3445,7700,0.576,0.044,0.082,4.4%,8.2%
0500000US36089,36089,36,89,"St. Lawrence County, New York",111944,2146,109798,108464,103943,2259,1051,1074,26,111,1334,0.137,0500000US36089,St. Lawrence County,108505,2832,105673,101893,96556,2788,1143,1089,19,298,3780,0.205,0.069,0.502,6.9%,50.2%
0500000US36091,36091,36,91,"Saratoga County, New York",219607,5279,214328,211167,203647,3053,325,3880,35,227,3161,0.139,0500000US36091,Saratoga County,235509,8667,226842,216171,203781,3752,301,7444,60,833,10671,0.247,0.108,0.777,10.8%,77.7%
0500000US36093,36093,36,93,"Schenectady County, New York",154727,8827,145900,141088,119409,13528,445,4917,81,2708,4812,0.391,0500000US36093,Schenectady County,158061,12505,145556,134631,104878,15943,930,8281,130,4469,10925,0.535,0.144,0.367,14.4%,36.7%
0500000US36095,36095,36,95,"Schoharie County, New York",32749,924,31825,31440,30742,394,54,217,3,30,385,0.118,0500000US36095,Schoharie County,29714,1075,28639,27339,26658,277,68,210,3,123,1300,0.192,0.074,0.629,7.4%,62.9%
0500000US36097,36097,36,97,"Schuyler County, New York",18343,234,18109,17898,17646,143,44,51,4,10,211,0.074,0500000US36097,Schuyler County,17898,329,17569,16899,16618,91,38,108,1,43,670,0.136,0.062,0.835,6.2%,83.5%
0500000US36099,36099,36,99,"Seneca County, New York",35251,952,34299,33895,31999,1513,96,238,2,47,404,0.173,0500000US36099,Seneca County,33814,1367,32447,31038,29273,1263,151,268,3,80,1409,0.246,0.072,0.418,7.2%,41.8%
0500000US36101,36101,36,101,"Steuben County, New York",98990,1371,97619,96387,93476,1487,193,1151,14,66,1232,0.108,0500000US36101,Steuben County,93584,1718,91866,87886,84338,1416,203,1616,12,301,3980,0.185,0.078,0.721,7.8%,72.1%
0500000US36103,36103,36,103,"Suffolk County, New York",1493350,246239,1247111,1227362,1068728,102117,2906,50295,275,3041,19749,0.455,0500000US36103,Suffolk County,1525920,332959,1192961,1152439,967330,107268,3102,65019,241,9479,40522,0.543,0.088,0.194,8.8%,19.4%
0500000US36105,36105,36,105,"Sullivan County, New York",77547,10554,66993,65593,57780,6349,228,1033,14,189,1400,0.419,0500000US36105,Sullivan County,78624,14007,64617,61115,52691,6069,174,1569,10,602,3502,0.511,0.092,0.219,9.2%,21.9%
0500000US36107,36107,36,107,"Tioga County, New York",51125,694,50431,49936,49105,349,73,371,12,26,495,0.077,0500000US36107,Tioga County,48455,1117,47338,45231,44195,434,62,370,12,158,2107,0.166,0.088,1.147,8.8%,114.7%
0500000US36109,36109,36,109,"Tompkins County, New York",101564,4264,97300,94484,81490,3773,270,8680,40,231,2816,0.345,0500000US36109,Tompkins County,105740,7077,98663,92403,76737,4274,248,10487,35,622,6260,0.454,0.109,0.315,10.9%,31.5%
0500000US36111,36111,36,111,"Ulster County, New York",182493,15909,166584,162928,149099,9982,414,3060,29,344,3656,0.321,0500000US36111,Ulster County,181851,21119,160732,152194,136695,10152,306,3778,45,1218,8538,0.416,0.094,0.294,9.4%,29.4%
0500000US36113,36113,36,113,"Warren County, New York",65707,1178,64529,63749,62585,556,117,449,5,37,780,0.092,0500000US36113,Warren County,65737,1752,63985,61092,59299,736,139,729,0,189,2893,0.183,0.091,0.989,9.1%,98.9%
0500000US36115,36115,36,115,"Washington County, New York",63216,1446,61770,61191,58996,1734,109,260,11,81,579,0.128,0500000US36115,Washington County,61302,1761,59541,56801,54605,1563,149,319,22,143,2740,0.203,0.075,0.590,7.5%,59.0%
0500000US36117,36117,36,117,"Wayne County, New York",93772,3476,90296,88810,85318,2743,201,465,24,59,1486,0.170,0500000US36117,Wayne County,91283,4514,86769,82556,79230,2397,171,473,13,272,4213,0.241,0.072,0.422,7.2%,42.2%
0500000US36119,36119,36,119,"Westchester County, New York",949113,207032,742081,727387,544563,126585,1141,51123,218,3757,14694,0.602,0500000US36119,Westchester County,1004457,269334,735123,703419,497684,131010,1017,64907,150,8651,31704,0.660,0.058,0.096,5.8%,9.6%
0500000US36121,36121,36,121,"Wyoming County, New York",42155,1244,40911,40621,38042,2233,103,156,7,80,290,0.182,0500000US36121,Wyoming County,40531,1490,39041,37814,35579,1852,83,217,6,77,1227,0.225,0.043,0.237,4.3%,23.7%
0500000US36123,36123,36,123,"Yates County, New York",25348,421,24927,24712,24371,196,35,96,1,13,215,0.075,0500000US36123,Yates County,24774,674,24100,23400,23049,145,28,93,8,77,700,0.133,0.058,0.767,5.8%,76.7%
0500000US37001,37001,37,1,"Alamance County, North Carolina",151131,16639,134492,132317,101718,27985,542,1806,55,211,2175,0.500,0500000US37001,Alamance County,171415,24703,146712,140285,102487,33555,584,2811,86,762,6427,0.582,0.081,0.163,8.1%,16.3%
0500000US37003,37003,37,3,"Alexander County, North Carolina",37198,1601,35597,35171,32671,2025,84,357,11,23,426,0.224,0500000US37003,Alexander County,36444,1836,34608,33397,30893,1919,111,390,1,83,1211,0.275,0.051,0.230,5.1%,23.0%
0500000US37005,37005,37,5,"Alleghany County, North Carolina",11155,1004,10151,10069,9862,133,18,53,2,1,82,0.210,0500000US37005,Alleghany County,10888,1288,9600,9349,9186,103,35,15,6,4,251,0.274,0.064,0.302,6.4%,30.2%
0500000US37007,37007,37,7,"Anson County, North Carolina",26948,812,26136,25842,12344,13038,148,281,4,27,294,0.555,0500000US37007,Anson County,22055,665,21390,20783,10593,9838,89,221,4,38,607,0.569,0.014,0.025,1.4%,2.5%
0500000US37009,37009,37,9,"Ashe County, North Carolina",27281,1311,25970,25739,25420,148,56,105,5,5,231,0.129,0500000US37009,Ashe County,26577,1519,25058,24358,24028,125,48,102,12,43,700,0.179,0.049,0.381,4.9%,38.1%
0500000US37011,37011,37,11,"Avery County, North Carolina",17797,797,17000,16881,16029,706,66,56,5,19,119,0.185,0500000US37011,Avery County,17806,987,16819,16357,15549,649,58,56,1,44,462,0.232,0.047,0.255,4.7%,25.5%
0500000US37013,37013,37,13,"Beaufort County, North Carolina",47759,3166,44593,44126,31705,12105,116,158,2,40,467,0.491,0500000US37013,Beaufort County,44652,3433,41219,40018,29431,10195,90,164,16,122,1201,0.507,0.016,0.033,1.6%,3.3%
0500000US37015,37015,37,15,"Bertie County, North Carolina",21282,267,21015,20842,7393,13252,88,103,0,6,173,0.491,0500000US37015,Bertie County,17934,330,17604,17141,6298,10674,57,63,0,49,463,0.521,0.030,0.061,3.0%,6.1%
0500000US37017,37017,37,17,"Bladen County, North Carolina",35190,2502,32688,32257,19242,12202,712,67,5,29,431,0.575,0500000US37017,Bladen County,29606,2546,27060,26158,15830,9505,701,47,8,67,902,0.602,0.027,0.047,2.7%,4.7%
0500000US37019,37019,37,19,"Brunswick County, North Carolina",107431,5549,101882,100311,86818,12120,652,560,33,128,1571,0.331,0500000US37019,Brunswick County,136693,7420,129273,124182,110716,11392,743,890,75,366,5091,0.333,0.001,0.004,0.1%,0.4%
0500000US37021,37021,37,21,"Buncombe County, North Carolina",238318,14254,224064,219992,201241,14979,778,2388,271,335,4072,0.279,0500000US37021,Buncombe County,269452,21922,247530,235729,214862,15017,727,3274,467,1382,11801,0.352,0.073,0.263,7.3%,26.3%
0500000US37023,37023,37,23,"Burke County, North Carolina",90912,4634,86278,85044,75472,5953,207,3163,162,87,1234,0.303,0500000US37023,Burke County,87570,7184,80386,77118,68664,4762,238,3150,64,240,3268,0.373,0.070,0.232,7.0%,23.2%
0500000US37025,37025,37,25,"Cabarrus County, North Carolina",178011,16767,161244,158493,127526,26660,497,3460,60,290,2751,0.455,0500000US37025,Cabarrus County,225804,27263,198541,189229,133781,41687,598,11933,122,1108,9312,0.596,0.141,0.310,14.1%,31.0%
0500000US37027,37027,37,27,"Caldwell County, North Carolina",83029,3796,79233,78256,73565,4025,159,421,16,70,977,0.210,0500000US37027,Caldwell County,80652,4923,75729,72687,67868,3843,196,527,15,238,3042,0.284,0.074,0.352,7.4%,35.2%
0500000US37029,37029,37,29,"Camden County, North Carolina",9980,215,9765,9582,8103,1299,32,145,3,0,183,0.323,0500000US37029,Camden County,10355,340,10015,9461,8200,1049,40,118,1,53,554,0.359,0.036,0.111,3.6%,11.1%
0500000US37031,37031,37,31,"Carteret County, North Carolina",66469,2241,64228,63106,58101,3986,283,576,63,97,1122,0.231,0500000US37031,Carteret County,67686,3119,64567,61897,57538,3208,252,584,63,252,2670,0.271,0.041,0.176,4.1%,17.6%
0500000US37033,37033,37,33,"Caswell County, North Carolina",23719,744,22975,22651,14513,7991,70,60,4,13,324,0.511,0500000US37033,Caswell County,22736,1002,21734,21036,14036,6804,65,61,13,57,698,0.526,0.015,0.030,1.5%,3.0%
0500000US37035,37035,37,35,"Catawba County, North Carolina",154358,13032,141326,139132,120388,12857,342,5311,34,200,2194,0.376,0500000US37035,Catawba County,160610,17377,143233,136681,116120,12628,379,6937,78,539,6552,0.456,0.080,0.212,8.0%,21.2%
0500000US37037,37037,37,37,"Chatham County, North Carolina",63505,8228,55277,54458,45185,8272,163,694,15,129,819,0.460,0500000US37037,Chatham County,76285,10372,65913,62976,53087,7768,173,1616,24,308,2937,0.485,0.025,0.055,2.5%,5.5%
0500000US37039,37039,37,39,"Cherokee County, North Carolina",27444,688,26756,26146,25341,327,336,131,8,3,610,0.146,0500000US37039,Cherokee County,28774,899,27875,26380,25366,373,417,158,0,66,1495,0.219,0.073,0.499,7.3%,49.9%
0500000US37041,37041,37,41,"Chowan County, North Carolina",14793,467,14326,14188,9040,5054,38,51,2,3,138,0.509,0500000US37041,Chowan County,13708,530,13178,12745,8268,4376,43,39,1,18,433,0.532,0.023,0.045,2.3%,4.5%
0500000US37043,37043,37,43,"Clay County, North Carolina",10587,258,10329,10202,10080,64,32,24,2,0,127,0.093,0500000US37043,Clay County,11089,438,10651,10218,10044,60,44,40,7,23,433,0.176,0.084,0.904,8.4%,90.4%
0500000US37045,37045,37,45,"Cleveland County, North Carolina",98078,2756,95322,94054,72793,20237,193,735,22,74,1268,0.406,0500000US37045,Cleveland County,99519,4039,95480,91623,70163,20034,222,854,23,327,3857,0.459,0.054,0.132,5.4%,13.2%
0500000US37047,37047,37,47,"Columbus County, North Carolina",58098,2662,55436,54690,35068,17587,1788,143,26,78,746,0.541,0500000US37047,Columbus County,50623,2613,48010,46501,30019,14503,1670,156,10,143,1509,0.562,0.021,0.038,2.1%,3.8%
0500000US37049,37049,37,49,"Craven County, North Carolina",103505,6272,97233,95002,69425,22868,420,2058,106,125,2231,0.497,0500000US37049,Craven County,100720,7195,93525,88809,64933,19903,318,3059,150,446,4716,0.537,0.040,0.081,4.0%,8.1%
0500000US37051,37051,37,51,"Cumberland County, North Carolina",319431,30190,289241,278013,150749,113939,4655,6885,1114,671,11228,0.639,0500000US37051,Cumberland County,334728,39498,295230,274527,133201,124173,4647,8943,1357,2206,20703,0.685,0.046,0.072,4.6%,7.2%
0500000US37053,37053,37,53,"Currituck County, North Carolina",23547,704,22843,22494,20876,1348,103,141,10,16,349,0.210,0500000US37053,Currituck County,28100,1218,26882,25376,23505,1377,98,265,22,109,1506,0.293,0.083,0.398,8.3%,39.8%
0500000US37055,37055,37,55,"Dare County, North Carolina",33920,2210,31710,31209,30061,812,101,211,10,14,501,0.210,0500000US37055,Dare County,36915,2554,34361,33108,31921,678,99,260,10,140,1253,0.246,0.036,0.174,3.6%,17.4%
0500000US37057,37057,37,57,"Davidson County, North Carolina",162878,10408,152470,150592,133486,14269,634,1957,26,220,1878,0.316,0500000US37057,Davidson County,168930,13902,155028,148965,129487,15839,665,2440,43,491,6063,0.395,0.079,0.250,7.9%,25.0%
0500000US37059,37059,37,59,"Davie County, North Carolina",41240,2496,38744,38188,35257,2552,106,228,6,39,556,0.261,0500000US37059,Davie County,42712,3375,39337,37724,34809,2413,96,277,5,124,1613,0.325,0.064,0.243,6.4%,24.3%
0500000US37061,37061,37,61,"Duplin County, North Carolina",58505,12059,46446,45981,30959,14640,173,135,28,46,465,0.615,0500000US37061,Duplin County,48715,10813,37902,36815,24945,11437,154,155,4,120,1087,0.633,0.018,0.029,1.8%,2.9%
0500000US37063,37063,37,63,"Durham County, North Carolina",267587,36077,231510,226694,112697,100260,722,12180,135,700,4816,0.662,0500000US37063,Durham County,324833,50104,274729,262296,133768,109225,704,16707,83,1809,12433,0.689,0.028,0.042,2.8%,4.2%
0500000US37065,37065,37,65,"Edgecombe County, North Carolina",56552,2104,54448,53971,21360,32318,128,113,7,45,477,0.529,0500000US37065,Edgecombe County,48900,2706,46194,45026,17340,27299,128,112,9,138,1168,0.559,0.030,0.056,3.0%,5.6%
0500000US37067,37067,37,67,"Forsyth County, North Carolina",350670,41775,308895,303640,205934,89533,894,6427,156,696,5255,0.575,0500000US37067,Forsyth County,382590,54688,327902,313877,208126,93738,978,9179,233,1623,14025,0.622,0.046,0.081,4.6%,8.1%
0500000US37069,37069,37,69,"Franklin County, North Carolina",60619,4776,55843,55070,38478,15995,253,272,5,67,773,0.521,0500000US37069,Franklin County,68573,6962,61611,59075,42285,15785,259,452,17,277,2536,0.555,0.034,0.065,3.4%,6.5%
0500000US37071,37071,37,71,"Gaston County, North Carolina",206086,12201,193885,190798,156310,31002,707,2462,44,273,3087,0.398,0500000US37071,Gaston County,227943,20068,207875,198580,153653,39762,753,3509,59,844,9295,0.506,0.107,0.269,10.7%,26.9%
0500000US37073,37073,37,73,"Gates County, North Carolina",12197,173,12024,11825,7684,4040,62,17,6,16,199,0.493,0500000US37073,Gates County,10478,201,10277,9851,6705,3022,64,21,10,29,426,0.505,0.012,0.025,1.2%,2.5%
0500000US37075,37075,37,75,"Graham County, North Carolina",8861,194,8667,8528,7942,17,538,29,2,0,139,0.192,0500000US37075,Graham County,8030,219,7811,7529,6885,46,570,20,4,4,282,0.258,0.066,0.341,6.6%,34.1%
0500000US37077,37077,37,77,"Granville County, North Carolina",59916,4482,55434,54653,34550,19454,250,321,22,56,781,0.556,0500000US37077,Granville County,60992,6211,54781,52727,33610,18315,205,366,24,207,2054,0.595,0.038,0.069,3.8%,6.9%
0500000US37079,37079,37,79,"Greene County, North Carolina",21362,3054,18308,18118,10038,7902,98,67,2,11,190,0.622,0500000US37079,Greene County,20451,2936,17515,17060,9644,7206,95,37,0,78,455,0.632,0.011,0.017,1.1%,1.7%
0500000US37081,37081,37,81,"Guilford County, North Carolina",488406,34826,453580,444656,265228,156982,2071,19059,193,1123,8924,0.595,0500000US37081,Guilford County,541299,52152,489147,468766,255640,179423,1918,28719,216,2850,20381,0.654,0.059,0.099,5.9%,9.9%
0500000US37083,37083,37,83,"Halifax County, North Carolina",54691,1152,53539,52977,21569,28986,2008,357,8,49,562,0.562,0500000US37083,Halifax County,48622,1454,47168,45834,19070,24737,1593,281,11,142,1334,0.585,0.023,0.041,2.3%,4.1%
0500000US37085,37085,37,85,"Harnett County, North Carolina",114678,12359,102319,99600,73707,23591,991,983,126,202,2719,0.532,0500000US37085,Harnett County,133568,18899,114669,107980,77876,26769,978,1408,242,707,6689,0.597,0.065,0.122,6.5%,12.2%
0500000US37087,37087,37,87,"Haywood County, North Carolina",59036,1999,57037,56503,55368,615,270,212,8,30,534,0.119,0500000US37087,Haywood County,62089,2829,59260,57166,55685,656,308,360,1,156,2094,0.192,0.073,0.615,7.3%,61.5%
0500000US37089,37089,37,89,"Henderson County, North Carolina",106740,10424,96316,94836,90105,3149,318,994,165,105,1480,0.277,0500000US37089,Henderson County,116281,14999,101282,97267,91747,3299,284,1296,241,400,4015,0.359,0.082,0.296,8.2%,29.6%
0500000US37091,37091,37,91,"Hertford County, North Carolina",24669,644,24025,23769,8479,14845,271,127,1,46,256,0.519,0500000US37091,Hertford County,21552,1579,19973,19339,6721,12215,188,113,3,99,634,0.575,0.056,0.109,5.6%,10.9%
0500000US37093,37093,37,93,"Hoke County, North Carolina",46952,5823,41129,39490,19142,15392,4313,467,88,88,1639,0.701,0500000US37093,Hoke County,52082,7687,44395,41096,19667,16385,3803,716,189,336,3299,0.727,0.026,0.037,2.6%,3.7%
0500000US37095,37095,37,95,"Hyde County, North Carolina",5810,411,5399,5334,3436,1833,22,16,1,26,65,0.546,0500000US37095,Hyde County,4589,347,4242,4111,2928,1152,7,7,2,15,131,0.523,-0.022,-0.041,-2.2%,-4.1%
0500000US37097,37097,37,97,"Iredell County, North Carolina",159437,10844,148593,146384,124107,18748,416,2899,36,178,2209,0.375,0500000US37097,Iredell County,186693,15777,170916,163517,136393,21255,437,4718,58,656,7399,0.444,0.069,0.184,6.9%,18.4%
0500000US37099,37099,37,99,"Jackson County, North Carolina",40271,2038,38233,37556,32795,729,3656,339,14,23,677,0.325,0500000US37099,Jackson County,43109,3292,39817,37997,32800,736,3849,497,10,105,1820,0.405,0.080,0.245,8.0%,24.5%
0500000US37101,37101,37,101,"Johnston County, North Carolina",168878,21814,147064,144880,117869,25082,689,976,33,231,2184,0.474,0500000US37101,Johnston County,215999,34400,181599,173200,136464,33041,880,1831,71,913,8399,0.550,0.077,0.162,7.7%,16.2%
0500000US37103,37103,37,103,"Jones County, North Carolina",10153,398,9755,9590,6217,3276,51,32,2,12,165,0.519,0500000US37103,Jones County,9172,394,8778,8460,5787,2564,42,32,0,35,318,0.521,0.002,0.003,0.2%,0.3%
0500000US37105,37105,37,105,"Lee County, North Carolina",57866,10576,47290,46511,34321,11369,253,475,13,80,779,0.576,0500000US37105,Lee County,63285,13122,50163,47900,36055,10701,231,643,43,227,2263,0.602,0.026,0.046,2.6%,4.6%
0500000US37107,37107,37,107,"Lenoir County, North Carolina",59495,3917,55578,54971,30492,23968,163,256,26,66,607,0.571,0500000US37107,Lenoir County,55122,4365,50757,49239,26582,22034,134,332,22,135,1518,0.601,0.030,0.053,3.0%,5.3%
0500000US37109,37109,37,109,"Lincoln County, North Carolina",78265,5238,73027,72147,67139,4269,222,415,13,89,880,0.256,0500000US37109,Lincoln County,86810,6412,80398,77218,71661,4405,237,692,15,208,3180,0.309,0.053,0.205,5.3%,20.5%
0500000US37111,37111,37,111,"McDowell County, North Carolina",44996,2392,42604,42144,39982,1663,131,344,0,24,460,0.206,0500000US37111,McDowell County,44578,2947,41631,40148,37788,1707,136,388,0,129,1483,0.274,0.068,0.331,6.8%,33.1%
0500000US37113,37113,37,113,"Macon County, North Carolina",33922,2230,31692,31393,30599,419,143,201,3,28,299,0.182,0500000US37113,Macon County,37014,3498,33516,32313,31535,252,167,250,6,103,1203,0.264,0.082,0.453,8.2%,45.3%
0500000US37115,37115,37,115,"Madison County, North Carolina",20764,423,20341,20105,19734,233,43,70,8,17,236,0.096,0500000US37115,Madison County,21193,748,20445,19644,19233,197,56,84,1,73,801,0.174,0.078,0.807,7.8%,80.7%
0500000US37117,37117,37,117,"Martin County, North Carolina",24505,769,23736,23542,12790,10601,65,71,5,10,194,0.539,0500000US37117,Martin County,22031,895,21136,20628,11528,8868,69,98,1,64,508,0.562,0.023,0.042,2.3%,4.2%
0500000US37119,37119,37,119,"Mecklenburg County, North Carolina",919628,111944,807684,791173,465372,278042,2843,41991,518,2407,16511,0.635,0500000US37119,Mecklenburg County,1115482,169922,945560,905248,498683,324832,2730,71583,531,6889,40312,0.687,0.051,0.081,5.1%,8.1%
0500000US37121,37121,37,121,"Mitchell County, North Carolina",15579,631,14948,14801,14656,53,36,46,1,9,147,0.113,0500000US37121,Mitchell County,14903,701,14202,13677,13514,50,30,52,1,30,525,0.174,0.061,0.539,6.1%,53.9%
0500000US37123,37123,37,123,"Montgomery County, North Carolina",27798,3926,23872,23617,17875,5182,102,439,3,16,255,0.531,0500000US37123,Montgomery County,25751,3924,21827,21212,16504,4192,76,391,2,47,615,0.539,0.007,0.014,0.7%,1.4%
0500000US37125,37125,37,125,"Moore County, North Carolina",88247,5261,82986,81757,68487,11727,689,736,25,93,1229,0.376,0500000US37125,Moore County,99727,7365,92362,88271,75391,10545,688,1237,59,351,4091,0.410,0.034,0.090,3.4%,9.0%
0500000US37127,37127,37,127,"Nash County, North Carolina",95840,6015,89825,88628,51770,35449,567,713,17,112,1197,0.567,0500000US37127,Nash County,94970,7322,87648,84950,46317,36679,615,904,28,407,2698,0.606,0.039,0.069,3.9%,6.9%
0500000US37129,37129,37,129,"New Hanover County, North Carolina",202667,10716,191951,188739,155631,29469,798,2380,108,353,3212,0.386,0500000US37129,New Hanover County,225702,17300,208402,199410,167150,26974,678,3468,148,992,8992,0.430,0.044,0.113,4.4%,11.3%
0500000US37131,37131,37,131,"Northampton County, North Carolina",22099,305,21794,21602,8596,12847,90,38,1,30,192,0.510,0500000US37131,Northampton County,17471,353,17118,16634,6835,9649,43,27,4,76,484,0.541,0.030,0.059,3.0%,5.9%
0500000US37133,37133,37,133,"Onslow County, North Carolina",177772,17896,159876,154039,122558,26577,1013,3163,438,290,5837,0.491,0500000US37133,Onslow County,204576,27641,176935,163890,129499,26939,1019,4508,777,1148,13045,0.559,0.068,0.139,6.8%,13.9%
0500000US37135,37135,37,135,"Orange County, North Carolina",133801,11017,122784,120123,94671,15722,383,8996,35,316,2661,0.474,0500000US37135,Orange County,148696,15812,132884,125898,96537,15571,334,12615,43,798,6986,0.547,0.073,0.154,7.3%,15.4%
0500000US37137,37137,37,137,"Pamlico County, North Carolina",13144,412,12732,12582,9828,2618,72,48,10,6,150,0.400,0500000US37137,Pamlico County,12276,496,11780,11323,9104,2055,58,50,5,51,457,0.419,0.019,0.047,1.9%,4.7%
0500000US37139,37139,37,139,"Pasquotank County, North Carolina",40661,1642,39019,38276,22369,15256,124,449,15,63,743,0.554,0500000US37139,Pasquotank County,40568,2237,38331,36707,21577,14316,150,458,28,178,1624,0.588,0.033,0.060,3.3%,6.0%
0500000US37141,37141,37,141,"Pender County, North Carolina",52217,3194,49023,48282,38568,9208,237,197,11,61,741,0.419,0500000US37141,Pender County,60203,4982,55221,52742,44418,7544,195,319,23,243,2479,0.431,0.012,0.029,1.2%,2.9%
0500000US37143,37143,37,143,"Perquimans County, North Carolina",13453,286,13167,13021,9608,3328,39,36,2,8,146,0.428,0500000US37143,Perquimans County,13005,309,12696,12138,9333,2686,35,36,7,41,558,0.440,0.012,0.027,1.2%,2.7%
0500000US37145,37145,37,145,"Person County, North Carolina",39464,1593,37871,37367,26354,10599,244,115,4,51,504,0.480,0500000US37145,Person County,39097,2195,36902,35504,25132,9879,240,124,8,121,1398,0.518,0.038,0.080,3.8%,8.0%
0500000US37147,37147,37,147,"Pitt County, North Carolina",168148,9202,158946,156247,96038,56813,474,2561,71,290,2699,0.556,0500000US37147,Pitt County,170243,12968,157275,151046,86837,59813,494,3056,94,752,6229,0.609,0.053,0.095,5.3%,9.5%
0500000US37149,37149,37,149,"Polk County, North Carolina",20510,1122,19388,19153,18126,911,41,60,1,14,235,0.214,0500000US37149,Polk County,19328,1026,18302,17564,16716,689,51,60,7,41,738,0.246,0.033,0.152,3.3%,15.2%
0500000US37151,37151,37,151,"Randolph County, North Carolina",141752,14698,127054,125424,115205,7979,674,1406,20,140,1630,0.325,0500000US37151,Randolph County,144171,19051,125120,120192,108354,8592,666,2158,10,412,4928,0.413,0.087,0.269,8.7%,26.9%
0500000US37153,37153,37,153,"Richmond County, North Carolina",46639,2741,43898,43094,27369,14159,1069,419,15,63,804,0.559,0500000US37153,Richmond County,42946,3072,39874,37908,23610,12770,994,360,7,167,1966,0.602,0.042,0.076,4.2%,7.6%
0500000US37155,37155,37,155,"Robeson County, North Carolina",134168,10932,123236,120537,36160,32347,50866,971,60,133,2699,0.718,0500000US37155,Robeson County,116530,11757,104773,100284,29159,26218,43536,897,63,411,4489,0.735,0.017,0.024,1.7%,2.4%
0500000US37157,37157,37,157,"Rockingham County, North Carolina",93643,5159,88484,87144,68744,17529,307,423,44,97,1340,0.423,0500000US37157,Rockingham County,91096,6086,85010,81920,64218,16611,282,493,29,287,3090,0.464,0.041,0.098,4.1%,9.8%
0500000US37159,37159,37,159,"Rowan County, North Carolina",138428,10644,127784,126060,101986,22153,376,1353,44,148,1724,0.425,0500000US37159,Rowan County,146875,15940,130935,125420,100135,22730,444,1505,71,535,5515,0.498,0.072,0.170,7.2%,17.0%
0500000US37161,37161,37,161,"Rutherford County, North Carolina",67810,2397,65413,64374,57054,6804,156,289,5,66,1039,0.281,0500000US37161,Rutherford County,64444,3286,61158,58590,52026,5836,152,343,23,210,2568,0.336,0.055,0.197,5.5%,19.7%
0500000US37163,37163,37,163,"Sampson County, North Carolina",63431,10440,52991,52173,33754,16948,1130,217,43,81,818,0.618,0500000US37163,Sampson County,59036,12249,46787,45065,29729,13944,1002,216,18,156,1722,0.646,0.029,0.046,2.9%,4.6%
0500000US37165,37165,37,165,"Scotland County, North Carolina",36157,754,35403,34681,16605,13884,3860,276,7,49,722,0.629,0500000US37165,Scotland County,34174,1106,33068,31512,14247,13094,3705,339,15,112,1556,0.664,0.035,0.056,3.5%,5.6%
0500000US37167,37167,37,167,"Stanly County, North Carolina",60585,2166,58419,57807,49877,6590,175,1108,10,47,612,0.309,0500000US37167,Stanly County,62504,3086,59418,57135,48645,7000,210,1140,9,131,2283,0.378,0.069,0.223,6.9%,22.3%
0500000US37169,37169,37,169,"Stokes County, North Carolina",47401,1254,46147,45653,43447,1897,138,125,7,39,494,0.157,0500000US37169,Stokes County,44520,1456,43064,41614,39609,1619,140,158,11,77,1450,0.205,0.048,0.302,4.8%,30.2%
0500000US37171,37171,37,171,"Surry County, North Carolina",73673,7155,66518,65834,62611,2644,173,339,9,58,684,0.267,0500000US37171,Surry County,71359,8496,62863,60843,57771,2413,130,370,11,148,2020,0.328,0.062,0.230,6.2%,23.0%
0500000US37173,37173,37,173,"Swain County, North Carolina",13981,540,13441,12901,9168,75,3587,66,4,1,540,0.501,0500000US37173,Swain County,14117,592,13525,12780,8541,102,4030,53,10,44,745,0.548,0.047,0.093,4.7%,9.3%
0500000US37175,37175,37,175,"Transylvania County, North Carolina",33090,964,32126,31605,30049,1279,93,143,8,33,521,0.173,0500000US37175,Transylvania County,32986,1698,31288,29981,28542,1027,102,173,22,115,1307,0.246,0.073,0.424,7.3%,42.4%
0500000US37177,37177,37,177,"Tyrrell County, North Carolina",4407,240,4167,4116,2350,1677,7,80,1,1,51,0.567,0500000US37177,Tyrrell County,3245,272,2973,2874,1879,934,5,43,0,13,99,0.574,0.006,0.011,0.6%,1.1%
0500000US37179,37179,37,179,"Union County, North Carolina",201292,20967,180325,177553,150098,23134,605,3243,58,415,2772,0.419,0500000US37179,Union County,238267,30110,208157,199059,161113,26500,641,9516,90,1199,9098,0.511,0.092,0.219,9.2%,21.9%
0500000US37181,37181,37,181,"Vance County, North Carolina",45422,3051,42371,41904,19101,22477,79,199,7,41,467,0.574,0500000US37181,Vance County,42578,3717,38861,37818,16243,21081,91,284,9,110,1043,0.601,0.027,0.048,2.7%,4.8%
0500000US37183,37183,37,183,"Wake County, North Carolina",900993,87922,813071,796225,560536,182793,2537,48287,317,1755,16846,0.559,0500000US37183,Wake County,1129410,128241,1001169,955643,645020,204535,2760,96665,453,6210,45526,0.619,0.060,0.108,6.0%,10.8%
0500000US37185,37185,37,185,"Warren County, North Carolina",20972,692,20280,19981,7971,10911,1026,49,3,21,299,0.581,0500000US37185,Warren County,18642,739,17903,17342,7209,9049,953,62,4,65,561,0.610,0.029,0.049,2.9%,4.9%
0500000US37187,37187,37,187,"Washington County, North Carolina",13228,466,12762,12639,5998,6567,21,38,1,14,123,0.547,0500000US37187,Washington County,11003,371,10632,10399,4958,5350,15,37,3,36,233,0.559,0.012,0.023,1.2%,2.3%
0500000US37189,37189,37,189,"Watauga County, North Carolina",51079,1713,49366,48774,47268,855,117,467,13,54,592,0.142,0500000US37189,Watauga County,54086,3521,50565,48556,44986,2101,82,938,11,438,2009,0.301,0.159,1.117,15.9%,111.7%
0500000US37191,37191,37,191,"Wayne County, North Carolina",122623,12162,110461,108339,68216,38107,333,1405,47,231,2122,0.584,0500000US37191,Wayne County,117333,14927,102406,97930,60199,35329,335,1542,71,454,4476,0.628,0.045,0.076,4.5%,7.6%
0500000US37193,37193,37,193,"Wilkes County, North Carolina",69340,3772,65568,64859,61587,2785,110,295,15,67,709,0.206,0500000US37193,Wilkes County,65969,4654,61315,59442,56316,2580,86,324,5,131,1873,0.264,0.057,0.278,5.7%,27.8%
0500000US37195,37195,37,195,"Wilson County, North Carolina",81234,7724,73510,72603,40157,31462,190,664,22,108,907,0.596,0500000US37195,Wilson County,78784,9024,69760,67354,36106,29842,239,900,10,257,2406,0.632,0.036,0.060,3.6%,6.0%
0500000US37197,37197,37,197,"Yadkin County, North Carolina",38406,3749,34657,34340,33022,1165,66,71,5,11,317,0.250,0500000US37197,Yadkin County,37214,4382,32832,31720,30357,1071,63,142,0,87,1112,0.319,0.069,0.275,6.9%,27.5%
0500000US37199,37199,37,199,"Yancey County, North Carolina",17818,814,17004,16864,16652,128,42,34,2,6,140,0.124,0500000US37199,Yancey County,18470,1016,17454,16867,16625,104,57,40,1,40,587,0.186,0.061,0.493,6.1%,49.3%
0500000US38001,38001,38,1,"Adams County, North Dakota",2343,20,2323,2300,2266,8,15,9,2,0,23,0.064,0500000US38001,Adams County,2200,36,2164,2094,2028,12,14,39,1,0,70,0.149,0.084,1.307,8.4%,130.7%
0500000US38003,38003,38,3,"Barnes County, North Dakota",11066,123,10943,10813,10599,83,71,58,1,1,130,0.082,0500000US38003,Barnes County,10853,185,10668,10328,9964,177,92,69,2,24,340,0.155,0.073,0.890,7.3%,89.0%
0500000US38005,38005,38,5,"Benson County, North Dakota",6660,77,6583,6497,2861,1,3631,3,1,0,86,0.518,0500000US38005,Benson County,5964,89,5875,5732,2532,2,3190,7,0,1,143,0.533,0.015,0.029,1.5%,2.9%
0500000US38007,38007,38,7,"Billings County, North Dakota",783,4,779,778,771,0,3,4,0,0,1,0.030,0500000US38007,Billings County,945,22,923,915,902,4,3,6,0,0,8,0.088,0.058,1.908,5.8%,190.8%
0500000US38009,38009,38,9,"Bottineau County, North Dakota",6429,82,6347,6236,6062,25,130,16,1,2,111,0.110,0500000US38009,Bottineau County,6379,141,6238,5972,5688,31,197,42,1,13,266,0.202,0.092,0.833,9.2%,83.3%
0500000US38011,38011,38,11,"Bowman County, North Dakota",3151,78,3073,3057,3039,3,13,2,0,0,16,0.069,0500000US38011,Bowman County,2993,129,2864,2814,2760,0,34,17,3,0,50,0.147,0.078,1.130,7.8%,113.0%
0500000US38013,38013,38,13,"Burke County, North Dakota",1968,37,1931,1920,1891,4,12,13,0,0,11,0.076,0500000US38013,Burke County,2201,59,2142,2099,2049,12,21,12,0,5,43,0.132,0.056,0.732,5.6%,73.2%
0500000US38015,38015,38,15,"Burleigh County, North Dakota",81308,986,80322,79280,75054,476,3284,386,26,54,1042,0.146,0500000US38015,Burleigh County,98458,3084,95374,92198,84349,2227,4053,1043,316,210,3176,0.262,0.116,0.794,11.6%,79.4%
0500000US38017,38017,38,17,"Cass County, North Dakota",149778,3015,146763,144296,135530,3372,1681,3524,49,140,2467,0.179,0500000US38017,Cass County,184525,6182,178343,171142,149442,12761,2367,6034,79,459,7201,0.335,0.156,0.870,15.6%,87.0%
0500000US38019,38019,38,19,"Cavalier County, North Dakota",3993,24,3969,3940,3890,4,35,9,1,1,29,0.051,0500000US38019,Cavalier County,3704,45,3659,3546,3485,2,28,16,0,15,113,0.114,0.063,1.238,6.3%,123.8%
0500000US38021,38021,38,21,"Dickey County, North Dakota",5289,100,5189,5133,5044,35,30,22,1,1,56,0.090,0500000US38021,Dickey County,4999,199,4800,4661,4572,19,26,27,0,17,139,0.161,0.071,0.791,7.1%,79.1%
0500000US38023,38023,38,23,"Divide County, North Dakota",2071,30,2041,2027,2006,5,10,6,0,0,14,0.061,0500000US38023,Divide County,2195,53,2142,2082,2024,23,17,11,4,3,60,0.148,0.087,1.410,8.7%,141.0%
0500000US38025,38025,38,25,"Dunn County, North Dakota",3536,38,3498,3445,2984,8,443,10,0,0,53,0.272,0500000US38025,Dunn County,4095,107,3988,3761,3241,23,455,32,0,10,227,0.357,0.086,0.315,8.6%,31.5%
0500000US38027,38027,38,27,"Eddy County, North Dakota",2385,52,2333,2311,2242,4,57,6,2,0,22,0.115,0500000US38027,Eddy County,2347,77,2270,2167,2102,5,60,0,0,0,103,0.194,0.079,0.686,7.9%,68.6%
0500000US38029,38029,38,29,"Emmons County, North Dakota",3550,34,3516,3490,3468,2,14,6,0,0,26,0.045,0500000US38029,Emmons County,3301,35,3266,3195,3162,0,13,12,0,8,71,0.082,0.036,0.799,3.6%,79.9%
0500000US38031,38031,38,31,"Foster County, North Dakota",3343,29,3314,3298,3272,3,20,3,0,0,16,0.042,0500000US38031,Foster County,3397,66,3331,3243,3199,7,18,13,0,6,88,0.112,0.070,1.676,7.0%,167.6%
0500000US38033,38033,38,33,"Golden Valley County, North Dakota",1680,35,1645,1634,1613,9,10,1,1,0,11,0.078,0500000US38033,Golden Valley County,1736,48,1688,1623,1600,5,12,1,1,4,65,0.148,0.071,0.911,7.1%,91.1%
0500000US38035,38035,38,35,"Grand Forks County, North Dakota",66861,1951,64910,63527,59271,1322,1592,1280,35,27,1383,0.212,0500000US38035,Grand Forks County,73170,3657,69513,66101,58755,3009,1637,2479,52,169,3412,0.347,0.136,0.641,13.6%,64.1%
0500000US38037,38037,38,37,"Grant County, North Dakota",2394,7,2387,2356,2325,1,27,3,0,0,31,0.057,0500000US38037,Grant County,2301,26,2275,2222,2169,10,32,11,0,0,53,0.111,0.054,0.956,5.4%,95.6%
0500000US38039,38039,38,39,"Griggs County, North Dakota",2420,9,2411,2410,2387,7,8,4,0,4,1,0.027,0500000US38039,Griggs County,2306,24,2282,2231,2200,8,12,7,0,4,51,0.089,0.062,2.297,6.2%,229.7%
0500000US38041,38041,38,41,"Hettinger County, North Dakota",2477,12,2465,2433,2372,6,51,1,3,0,32,0.082,0500000US38041,Hettinger County,2489,34,2455,2386,2319,5,42,5,7,8,69,0.131,0.048,0.587,4.8%,58.7%
0500000US38043,38043,38,43,"Kidder County, North Dakota",2435,71,2364,2360,2329,6,3,22,0,0,4,0.084,0500000US38043,Kidder County,2394,52,2342,2291,2271,3,11,1,5,0,51,0.099,0.015,0.177,1.5%,17.7%
0500000US38045,38045,38,45,"LaMoure County, North Dakota",4139,34,4105,4080,4053,5,16,6,0,0,25,0.041,0500000US38045,LaMoure County,4093,88,4005,3944,3897,6,20,7,4,10,61,0.093,0.052,1.262,5.2%,126.2%
0500000US38047,38047,38,47,"Logan County, North Dakota",1990,12,1978,1969,1954,2,8,5,0,0,9,0.036,0500000US38047,Logan County,1876,35,1841,1787,1773,2,11,0,0,1,54,0.106,0.070,1.951,7.0%,195.1%
0500000US38049,38049,38,49,"McHenry County, North Dakota",5395,80,5315,5270,5218,8,28,16,0,0,45,0.064,0500000US38049,McHenry County,5345,98,5247,5080,5024,11,27,12,6,0,167,0.115,0.051,0.793,5.1%,79.3%
0500000US38051,38051,38,51,"McIntosh County, North Dakota",2809,38,2771,2753,2725,6,12,10,0,0,18,0.059,0500000US38051,McIntosh County,2530,53,2477,2418,2375,7,5,23,0,8,59,0.118,0.059,1.007,5.9%,100.7%
0500000US38053,38053,38,53,"McKenzie County, North Dakota",6360,139,6221,6124,4746,4,1349,19,2,4,97,0.397,0500000US38053,McKenzie County,14704,1532,13172,12548,10268,214,1823,171,5,67,624,0.484,0.087,0.218,8.7%,21.8%
0500000US38055,38055,38,55,"McLean County, North Dakota",8962,111,8851,8723,8115,6,585,12,2,3,128,0.175,0500000US38055,McLean County,9771,148,9623,9242,8372,32,766,48,7,17,381,0.258,0.082,0.470,8.2%,47.0%
0500000US38057,38057,38,57,"Mercer County, North Dakota",8424,121,8303,8225,7996,16,174,27,12,0,78,0.098,0500000US38057,Mercer County,8350,218,8132,7868,7571,42,193,43,1,18,264,0.176,0.077,0.787,7.7%,78.7%
0500000US38059,38059,38,59,"Morton County, North Dakota",27471,400,27071,26693,25537,112,959,53,24,8,378,0.134,0500000US38059,Morton County,33291,1312,31979,30780,28796,462,1238,171,39,74,1199,0.247,0.113,0.843,11.3%,84.3%
0500000US38061,38061,38,61,"Mountrail County, North Dakota",7673,286,7387,7209,4931,16,2240,15,1,6,178,0.500,0500000US38061,Mountrail County,9809,768,9041,8531,5539,113,2737,105,3,34,510,0.594,0.094,0.189,9.4%,18.9%
0500000US38063,38063,38,63,"Nelson County, North Dakota",3126,33,3093,3057,3018,8,28,2,1,0,36,0.068,0500000US38063,Nelson County,3015,69,2946,2881,2844,6,16,9,1,5,65,0.109,0.042,0.616,4.2%,61.6%
0500000US38065,38065,38,65,"Oliver County, North Dakota",1846,19,1827,1815,1782,3,26,4,0,0,12,0.068,0500000US38065,Oliver County,1877,28,1849,1790,1755,3,23,5,3,1,59,0.124,0.057,0.835,5.7%,83.5%
0500000US38067,38067,38,67,"Pembina County, North Dakota",7413,190,7223,7127,6947,21,143,11,2,3,96,0.121,0500000US38067,Pembina County,6844,243,6601,6305,6096,27,133,27,0,22,296,0.203,0.083,0.684,8.3%,68.4%
0500000US38069,38069,38,69,"Pierce County, North Dakota",4357,44,4313,4280,4084,19,169,3,1,4,33,0.120,0500000US38069,Pierce County,3990,72,3918,3825,3611,36,146,17,5,10,93,0.179,0.059,0.492,5.9%,49.2%
0500000US38071,38071,38,71,"Ramsey County, North Dakota",11451,137,11314,11039,9980,41,964,45,5,4,275,0.233,0500000US38071,Ramsey County,11605,274,11331,10744,9354,73,1227,72,10,8,587,0.336,0.103,0.444,10.3%,44.4%
0500000US38073,38073,38,73,"Ransom County, North Dakota",5457,66,5391,5346,5285,19,21,20,0,1,45,0.062,0500000US38073,Ransom County,5703,129,5574,5451,5363,36,18,24,0,10,123,0.115,0.053,0.855,5.3%,85.5%
0500000US38075,38075,38,75,"Renville County, North Dakota",2470,24,2446,2417,2401,2,9,5,0,0,29,0.055,0500000US38075,Renville County,2282,37,2245,2167,2146,5,14,0,0,2,78,0.114,0.059,1.082,5.9%,108.2%
0500000US38077,38077,38,77,"Richland County, North Dakota",16321,271,16050,15868,15351,110,302,88,7,10,182,0.115,0500000US38077,Richland County,16529,574,15955,15456,14703,155,433,123,19,23,499,0.206,0.091,0.797,9.1%,79.7%
0500000US38079,38079,38,79,"Rolette County, North Dakota",13937,133,13804,13518,2802,21,10677,16,1,1,286,0.372,0500000US38079,Rolette County,12187,137,12050,11560,2298,13,9210,23,8,8,490,0.392,0.019,0.052,1.9%,5.2%
0500000US38081,38081,38,81,"Sargent County, North Dakota",3829,51,3778,3752,3717,2,20,9,2,2,26,0.057,0500000US38081,Sargent County,3862,91,3771,3639,3570,48,8,13,0,0,132,0.144,0.086,1.502,8.6%,150.2%
0500000US38083,38083,38,83,"Sheridan County, North Dakota",1321,16,1305,1290,1272,0,14,2,2,0,15,0.072,0500000US38083,Sheridan County,1265,10,1255,1214,1191,2,11,6,0,4,41,0.112,0.040,0.551,4.0%,55.1%
0500000US38085,38085,38,85,"Sioux County, North Dakota",4153,82,4071,3960,517,6,3433,4,0,0,111,0.300,0500000US38085,Sioux County,3898,63,3835,3687,401,3,3281,2,0,0,148,0.279,-0.021,-0.069,-2.1%,-6.9%
0500000US38087,38087,38,87,"Slope County, North Dakota",727,12,715,713,707,0,6,0,0,0,2,0.054,0500000US38087,Slope County,706,8,698,681,679,0,2,0,0,0,17,0.074,0.020,0.378,2.0%,37.8%
0500000US38089,38089,38,89,"Stark County, North Dakota",24199,454,23745,23491,22765,186,230,288,7,15,254,0.114,0500000US38089,Stark County,33646,2274,31372,30215,28307,1033,392,344,51,88,1157,0.285,0.171,1.497,17.1%,149.7%
0500000US38091,38091,38,91,"Steele County, North Dakota",1975,20,1955,1945,1916,3,23,2,0,1,10,0.059,0500000US38091,Steele County,1798,36,1762,1731,1721,3,7,0,0,0,31,0.083,0.025,0.418,2.5%,41.8%
0500000US38093,38093,38,93,"Stutsman County, North Dakota",21100,361,20739,20534,19996,126,297,99,12,4,205,0.101,0500000US38093,Stutsman County,21593,593,21000,20409,19504,444,296,137,4,24,591,0.182,0.081,0.797,8.1%,79.7%
0500000US38095,38095,38,95,"Towner County, North Dakota",2246,10,2236,2221,2165,2,49,1,0,4,15,0.070,0500000US38095,Towner County,2162,34,2128,2072,1984,2,71,10,1,4,56,0.156,0.086,1.218,8.6%,121.8%
0500000US38097,38097,38,97,"Traill County, North Dakota",8121,214,7907,7818,7693,39,63,21,1,1,89,0.102,0500000US38097,Traill County,7997,297,7700,7451,7311,48,60,18,4,10,249,0.162,0.060,0.590,6.0%,59.0%
0500000US38099,38099,38,99,"Walsh County, North Dakota",11119,969,10150,10054,9834,24,153,36,4,3,96,0.210,0500000US38099,Walsh County,10563,1316,9247,8957,8676,69,136,45,0,31,290,0.309,0.099,0.471,9.9%,47.1%
0500000US38101,38101,38,101,"Ward County, North Dakota",61675,1869,59806,58379,54717,1469,1533,550,76,34,1427,0.210,0500000US38101,Ward County,69919,4590,65329,61562,55673,2853,1570,1087,129,250,3767,0.356,0.146,0.695,14.6%,69.5%
0500000US38103,38103,38,103,"Wells County, North Dakota",4207,21,4186,4163,4143,3,13,4,0,0,23,0.030,0500000US38103,Wells County,3982,38,3944,3835,3784,18,17,12,0,4,109,0.096,0.066,2.189,6.6%,218.9%
0500000US38105,38105,38,105,"Williams County, North Dakota",22398,436,21962,21385,20364,57,878,78,5,3,577,0.171,0500000US38105,Williams County,40950,3897,37053,34801,30761,2041,1125,612,98,164,2252,0.420,0.249,1.460,24.9%,146.0%
0500000US39001,39001,39,1,"Adams County, Ohio",28550,243,28307,27946,27713,84,105,31,2,11,361,0.058,0500000US39001,Adams County,27477,217,27260,26416,26185,84,74,39,1,33,844,0.091,0.033,0.579,3.3%,57.9%
0500000US39003,39003,39,3,"Allen County, Ohio",106331,2513,103818,101387,87708,12508,162,725,13,271,2431,0.305,0500000US39003,Allen County,102206,3272,98934,93817,79691,12475,233,835,42,541,5117,0.374,0.069,0.226,6.9%,22.6%
0500000US39005,39005,39,5,"Ashland County, Ohio",53139,501,52638,52161,51352,395,77,275,39,23,477,0.066,0500000US39005,Ashland County,52447,862,51585,49871,48948,383,82,322,33,103,1714,0.128,0.062,0.936,6.2%,93.6%
0500000US39007,39007,39,7,"Ashtabula County, Ohio",101497,3441,98056,96226,92126,3467,208,372,17,36,1830,0.173,0500000US39007,Ashtabula County,97574,4489,93085,88320,84064,3492,154,338,12,260,4765,0.252,0.078,0.452,7.8%,45.2%
0500000US39009,39009,39,9,"Athens County, Ohio",64757,1002,63755,62481,58779,1741,140,1741,13,67,1274,0.174,0500000US39009,Athens County,62431,1450,60981,58544,54086,2768,223,1210,1,256,2437,0.245,0.071,0.408,7.1%,40.8%
0500000US39011,39011,39,11,"Auglaize County, Ohio",45949,543,45406,45030,44625,124,75,165,16,25,376,0.057,0500000US39011,Auglaize County,46422,781,45641,44303,43643,231,76,242,40,71,1338,0.115,0.058,1.032,5.8%,103.2%
0500000US39013,39013,39,13,"Belmont County, Ohio",70400,429,69971,69111,65902,2815,85,257,6,46,860,0.122,0500000US39013,Belmont County,66497,824,65673,63096,60536,2071,83,265,11,130,2577,0.169,0.047,0.383,4.7%,38.3%
0500000US39015,39015,39,15,"Brown County, Ohio",44846,269,44577,44149,43570,382,74,107,3,13,428,0.056,0500000US39015,Brown County,43676,487,43189,41620,41053,302,68,84,2,111,1569,0.115,0.059,1.058,5.9%,105.8%
0500000US39017,39017,39,17,"Butler County, Ohio",368130,14670,353460,346766,310183,26463,606,8759,239,516,6694,0.282,0500000US39017,Butler County,390357,25265,365092,347150,294712,34144,610,15658,480,1546,17942,0.414,0.132,0.468,13.2%,46.8%
0500000US39019,39019,39,19,"Carroll County, Ohio",28836,238,28598,28317,28044,133,70,56,0,14,281,0.054,0500000US39019,Carroll County,26721,299,26422,25510,25204,122,73,52,3,56,912,0.109,0.055,1.019,5.5%,101.9%
0500000US39021,39021,39,21,"Champaign County, Ohio",40097,451,39646,38946,37743,874,134,151,12,32,700,0.113,0500000US39021,Champaign County,38714,648,38066,36347,35314,683,79,125,7,139,1719,0.165,0.052,0.463,5.2%,46.3%
0500000US39023,39023,39,23,"Clark County, Ohio",138333,3805,134528,131405,117976,11999,302,849,47,232,3123,0.264,0500000US39023,Clark County,136001,5313,130688,123709,109794,12074,314,898,91,538,6979,0.336,0.072,0.274,7.2%,27.4%
0500000US39025,39025,39,25,"Clermont County, Ohio",197363,2896,194467,192061,187331,2234,349,1900,58,189,2406,0.098,0500000US39025,Clermont County,208601,4956,203645,194537,187749,3245,345,2529,58,611,9108,0.187,0.089,0.899,8.9%,89.9%
0500000US39027,39027,39,27,"Clinton County, Ohio",42040,559,41481,40755,39496,905,85,211,17,41,726,0.116,0500000US39027,Clinton County,42018,765,41253,39538,38247,819,96,205,6,165,1715,0.169,0.053,0.452,5.3%,45.2%
0500000US39029,39029,39,29,"Columbiana County, Ohio",107841,1348,106493,105207,102326,2323,164,319,20,55,1286,0.099,0500000US39029,Columbiana County,101877,1752,100125,96287,93466,2082,161,345,16,217,3838,0.156,0.057,0.579,5.7%,57.9%
0500000US39031,39031,39,31,"Coshocton County, Ohio",36901,279,36622,36224,35632,391,78,103,2,18,398,0.067,0500000US39031,Coshocton County,36612,401,36211,35180,34582,389,57,98,7,47,1031,0.107,0.039,0.587,3.9%,58.7%
0500000US39033,39033,39,33,"Crawford County, Ohio",43784,533,43251,42841,42227,375,48,156,7,28,410,0.070,0500000US39033,Crawford County,42025,638,41387,39946,39388,305,40,131,12,70,1441,0.120,0.051,0.727,5.1%,72.7%
0500000US39035,39035,39,35,"Cuyahoga County, Ohio",1280122,61270,1218852,1197637,785977,374968,2018,32615,217,1842,21215,0.534,0500000US39035,Cuyahoga County,1264817,83327,1181490,1135482,718753,365169,1827,43739,249,5745,46008,0.587,0.053,0.099,5.3%,9.9%
0500000US39037,39037,39,37,"Darke County, Ohio",52959,646,52313,51860,51365,233,71,159,4,28,453,0.059,0500000US39037,Darke County,51881,859,51022,49717,48994,302,92,181,26,122,1305,0.107,0.048,0.816,4.8%,81.6%
0500000US39039,39039,39,39,"Defiance County, Ohio",39037,3409,35628,35222,34345,666,65,117,11,18,406,0.218,0500000US39039,Defiance County,38286,3950,34336,33189,32276,598,79,133,15,88,1147,0.278,0.060,0.274,6.0%,27.4%
0500000US39041,39041,39,41,"Delaware County, Ohio",174214,3669,170545,167639,153969,5756,216,7393,47,258,2906,0.215,0500000US39041,Delaware County,214124,7012,207112,198405,171420,7702,242,18158,60,823,8707,0.348,0.133,0.616,13.3%,61.6%
0500000US39043,39043,39,43,"Erie County, Ohio",77079,2604,74475,72713,65463,6534,188,456,6,66,1762,0.270,0500000US39043,Erie County,75622,3130,72492,68553,61061,6655,121,474,10,232,3939,0.336,0.066,0.245,6.6%,24.5%
0500000US39045,39045,39,45,"Fairfield County, Ohio",146156,2510,143646,141119,130377,8609,278,1626,39,190,2527,0.200,0500000US39045,Fairfield County,158921,4021,154900,147862,130664,13302,287,3063,31,515,7038,0.314,0.114,0.569,11.4%,56.9%
0500000US39047,39047,39,47,"Fayette County, Ohio",29030,520,28510,28046,27227,569,59,151,8,32,464,0.119,0500000US39047,Fayette County,28951,681,28270,27094,26260,521,43,171,11,88,1176,0.175,0.055,0.463,5.5%,46.3%
0500000US39049,39049,39,49,"Franklin County, Ohio",1163414,55718,1107696,1077574,783048,244200,2280,44723,676,2647,30122,0.498,0500000US39049,Franklin County,1323807,91182,1232625,1167221,787615,296076,2160,73714,444,7212,65404,0.586,0.087,0.175,8.7%,17.5%
0500000US39051,39051,39,51,"Fulton County, Ohio",42698,3341,39357,38994,38569,138,84,176,4,23,363,0.178,0500000US39051,Fulton County,42713,3791,38922,37531,36968,225,60,152,6,120,1391,0.242,0.064,0.360,6.4%,36.0%
0500000US39053,39053,39,53,"Gallia County, Ohio",30934,275,30659,30213,29150,800,108,139,0,16,446,0.111,0500000US39053,Gallia County,29220,262,28958,27839,26955,597,55,148,5,79,1119,0.147,0.036,0.324,3.6%,32.4%
0500000US39055,39055,39,55,"Geauga County, Ohio",93389,1001,92388,91655,89766,1187,61,552,11,78,733,0.076,0500000US39055,Geauga County,95397,1664,93733,90963,88958,1075,36,666,8,220,2770,0.129,0.053,0.705,5.3%,70.5%
0500000US39057,39057,39,57,"Greene County, Ohio",161573,3439,158134,154318,137440,11506,367,4663,81,261,3816,0.269,0500000US39057,Greene County,167966,5216,162750,153697,135603,11285,330,5516,87,876,9053,0.339,0.069,0.257,6.9%,25.7%
0500000US39059,39059,39,59,"Guernsey County, Ohio",40087,349,39738,39085,38276,580,86,109,8,26,653,0.088,0500000US39059,Guernsey County,38438,444,37994,36545,35717,520,87,149,7,65,1449,0.135,0.047,0.536,4.7%,53.6%
0500000US39061,39061,39,61,"Hamilton County, Ohio",802374,20607,781767,766459,542273,204748,1219,16080,474,1665,15308,0.477,0500000US39061,Hamilton County,830639,36250,794389,758408,519734,207764,1173,25160,618,3959,35981,0.541,0.065,0.135,6.5%,13.5%
0500000US39063,39063,39,63,"Hancock County, Ohio",74782,3363,71419,70436,67888,1084,127,1258,11,68,983,0.173,0500000US39063,Hancock County,74920,4198,70722,68188,65107,1363,79,1393,26,220,2534,0.240,0.067,0.385,6.7%,38.5%
0500000US39065,39065,39,65,"Hardin County, Ohio",32058,407,31651,31275,30774,255,44,180,3,19,376,0.078,0500000US39065,Hardin County,30696,697,29999,28939,28389,256,48,169,8,69,1060,0.143,0.065,0.829,6.5%,82.9%
0500000US39067,39067,39,67,"Harrison County, Ohio",15864,79,15785,15541,15169,324,13,22,1,12,244,0.085,0500000US39067,Harrison County,14483,130,14353,13737,13425,234,14,40,6,18,616,0.139,0.054,0.630,5.4%,63.0%
0500000US39069,39069,39,69,"Henry County, Ohio",28215,1860,26355,26150,25861,103,73,103,0,10,205,0.155,0500000US39069,Henry County,27662,2187,25475,24839,24463,155,49,125,4,43,636,0.211,0.056,0.358,5.6%,35.8%
0500000US39071,39071,39,71,"Highland County, Ohio",43589,319,43270,42673,41852,597,99,99,1,25,597,0.078,0500000US39071,Highland County,43317,424,42893,41333,40492,518,109,110,8,96,1560,0.125,0.047,0.605,4.7%,60.5%
0500000US39073,39073,39,73,"Hocking County, Ohio",29380,198,29182,28877,28509,215,88,47,3,15,305,0.058,0500000US39073,Hocking County,28050,232,27818,26810,26502,139,45,71,0,53,1008,0.106,0.048,0.820,4.8%,82.0%
0500000US39075,39075,39,75,"Holmes County, Ohio",42366,329,42037,41836,41607,123,22,49,19,16,201,0.035,0500000US39075,Holmes County,44223,474,43749,43137,42875,119,33,64,5,41,612,0.060,0.024,0.686,2.4%,68.6%
0500000US39077,39077,39,77,"Huron County, Ohio",59626,3333,56293,55527,54649,560,116,170,10,22,766,0.157,0500000US39077,Huron County,58565,4084,54481,52277,51242,562,139,216,12,106,2204,0.228,0.071,0.456,7.1%,45.6%
0500000US39079,39079,39,79,"Jackson County, Ohio",33225,265,32960,32538,32096,191,115,109,12,15,422,0.067,0500000US39079,Jackson County,32653,306,32347,31233,30835,158,88,101,1,50,1114,0.107,0.040,0.608,4.0%,60.8%
0500000US39081,39081,39,81,"Jefferson County, Ohio",69709,773,68936,67821,63519,3856,88,284,8,66,1115,0.166,0500000US39081,Jefferson County,65249,1159,64090,60884,56545,3619,109,338,29,244,3206,0.243,0.077,0.463,7.7%,46.3%
0500000US39083,39083,39,83,"Knox County, Ohio",60921,737,60184,59515,58498,485,116,348,16,52,669,0.078,0500000US39083,Knox County,62721,1196,61525,59360,58058,565,118,365,17,237,2165,0.141,0.064,0.823,6.4%,82.3%
0500000US39085,39085,39,85,"Lake County, Ohio",230041,7825,222216,219176,208994,7156,234,2586,31,175,3040,0.172,0500000US39085,Lake County,232603,11362,221241,211980,197069,10778,236,3255,38,604,9261,0.276,0.104,0.602,10.4%,60.2%
0500000US39087,39087,39,87,"Lawrence County, Ohio",62450,445,62005,61218,59547,1267,111,240,3,50,787,0.090,0500000US39087,Lawrence County,58240,618,57622,55611,54016,1100,134,219,7,135,2011,0.138,0.048,0.532,4.8%,53.2%
0500000US39089,39089,39,89,"Licking County, Ohio",166492,2312,164180,161330,153811,5643,436,1224,33,183,2850,0.145,0500000US39089,Licking County,178519,3988,174531,166294,152935,7142,386,4999,45,787,8237,0.261,0.116,0.802,11.6%,80.2%
0500000US39091,39091,39,91,"Logan County, Ohio",45858,539,45319,44509,43385,728,102,238,16,40,810,0.104,0500000US39091,Logan County,46150,1004,45146,43024,41749,673,83,327,11,181,2122,0.179,0.075,0.715,7.5%,71.5%
0500000US39093,39093,39,93,"Lorain County, Ohio",301356,25290,276066,269562,241543,24289,635,2758,35,302,6504,0.343,0500000US39093,Lorain County,312964,32917,280047,265641,237520,22980,502,3569,50,1020,14406,0.405,0.062,0.180,6.2%,18.0%
0500000US39095,39095,39,95,"Lucas County, Ohio",441815,26974,414841,404537,313596,82541,955,6676,91,678,10304,0.457,0500000US39095,Lucas County,431279,32167,399112,378008,284663,83398,817,7089,115,1926,21104,0.519,0.062,0.136,6.2%,13.6%
0500000US39097,39097,39,97,"Madison County, Ohio",43435,622,42813,42226,38994,2852,88,231,8,53,587,0.189,0500000US39097,Madison County,43824,1263,42561,40917,37761,2664,59,253,4,176,1644,0.252,0.062,0.329,6.2%,32.9%
0500000US39099,39099,39,99,"Mahoning County, Ohio",238823,11136,227687,223954,185230,36400,392,1647,36,249,3733,0.373,0500000US39099,Mahoning County,228614,14093,214521,205911,169090,33770,332,1952,59,708,8610,0.426,0.053,0.142,5.3%,14.2%
0500000US39101,39101,39,101,"Marion County, Ohio",66501,1503,64998,63993,59733,3754,97,326,27,56,1005,0.189,0500000US39101,Marion County,65359,1956,63403,60845,56114,4051,140,358,15,167,2558,0.257,0.067,0.356,6.7%,35.6%
0500000US39103,39103,39,103,"Medina County, Ohio",172332,2747,169585,167751,163794,1982,216,1638,17,104,1834,0.096,0500000US39103,Medina County,182470,4592,177878,170928,165643,2292,192,2184,28,589,6950,0.174,0.077,0.807,7.7%,80.7%
0500000US39105,39105,39,105,"Meigs County, Ohio",23770,115,23655,23401,23087,202,50,51,1,10,254,0.056,0500000US39105,Meigs County,22210,172,22038,21442,21180,148,49,22,0,43,596,0.090,0.033,0.591,3.3%,59.1%
0500000US39107,39107,39,107,"Mercer County, Ohio",40814,614,40200,39893,39453,91,83,180,68,18,307,0.065,0500000US39107,Mercer County,42528,928,41600,40837,39752,191,63,189,564,78,763,0.125,0.060,0.919,6.0%,91.9%
0500000US39109,39109,39,109,"Miami County, Ohio",102506,1341,101165,99480,95908,2063,173,1213,13,110,1685,0.124,0500000US39109,Miami County,108774,2199,106575,101823,96964,2559,152,1644,21,483,4752,0.202,0.079,0.636,7.9%,63.6%
0500000US39111,39111,39,111,"Monroe County, Ohio",14642,59,14583,14420,14326,60,16,16,1,1,163,0.043,0500000US39111,Monroe County,13385,67,13318,12983,12909,19,12,21,3,19,335,0.069,0.027,0.627,2.7%,62.7%
0500000US39113,39113,39,113,"Montgomery County, Ohio",535153,12177,522976,511400,388917,111105,1096,9195,163,924,11576,0.427,0500000US39113,Montgomery County,537309,21179,516130,489697,360396,112818,937,12714,244,2588,26433,0.501,0.074,0.173,7.4%,17.3%
0500000US39115,39115,39,115,"Morgan County, Ohio",15054,97,14957,14487,13972,428,44,17,0,26,470,0.137,0500000US39115,Morgan County,13802,127,13675,13016,12525,396,20,24,2,49,659,0.173,0.037,0.267,3.7%,26.7%
0500000US39117,39117,39,117,"Morrow County, Ohio",34827,380,34447,34037,33772,117,40,84,9,15,410,0.059,0500000US39117,Morrow County,34950,580,34370,33173,32773,153,56,90,8,93,1197,0.119,0.060,1.007,6.0%,100.7%
0500000US39119,39119,39,119,"Muskingum County, Ohio",86074,650,85424,83413,79600,3214,169,285,14,131,2011,0.143,0500000US39119,Muskingum County,86410,1055,85355,80840,76947,2985,138,384,8,378,4515,0.203,0.060,0.421,6.0%,42.1%
0500000US39121,39121,39,121,"Noble County, Ohio",14645,52,14593,14483,14036,368,42,20,3,14,110,0.081,0500000US39121,Noble County,14115,173,13942,13656,12840,752,31,22,0,11,286,0.169,0.088,1.095,8.8%,109.5%
0500000US39123,39123,39,123,"Ottawa County, Ohio",41428,1755,39673,39276,38780,302,57,114,7,16,397,0.122,0500000US39123,Ottawa County,40364,2059,38305,37073,36436,335,47,157,6,92,1232,0.182,0.060,0.490,6.0%,49.0%
0500000US39125,39125,39,125,"Paulding County, Ohio",19614,838,18776,18602,18348,158,51,38,2,5,174,0.123,0500000US39125,Paulding County,18806,1010,17796,17248,16972,139,41,30,5,61,548,0.182,0.059,0.478,5.9%,47.8%
0500000US39127,39127,39,127,"Perry County, Ohio",36058,195,35863,35405,35170,92,86,37,6,14,458,0.048,0500000US39127,Perry County,35408,252,35156,33931,33595,90,94,67,0,85,1225,0.099,0.050,1.034,5.0%,103.4%
0500000US39129,39129,39,129,"Pickaway County, Ohio",55698,588,55110,54491,52259,1876,96,206,11,43,619,0.118,0500000US39129,Pickaway County,58539,903,57636,55150,52416,2143,131,296,11,153,2486,0.195,0.077,0.647,7.7%,64.7%
0500000US39131,39131,39,131,"Pike County, Ohio",28709,207,28502,28071,27610,251,138,55,3,14,431,0.075,0500000US39131,Pike County,27088,219,26869,25890,25470,190,110,70,6,44,979,0.114,0.040,0.532,4.0%,53.2%
0500000US39133,39133,39,133,"Portage County, Ohio",161419,2073,159346,156873,147527,6611,274,2283,33,145,2473,0.162,0500000US39133,Portage County,161791,3505,158286,150937,138774,7934,233,3400,38,558,7349,0.259,0.096,0.594,9.6%,59.4%
0500000US39135,39135,39,135,"Preble County, Ohio",42270,254,42016,41558,41088,177,82,170,2,39,458,0.055,0500000US39135,Preble County,40999,386,40613,39230,38700,182,84,162,4,98,1383,0.108,0.053,0.960,5.3%,96.0%
0500000US39137,39137,39,137,"Putnam County, Ohio",34499,1890,32609,32456,32246,79,46,78,3,4,153,0.123,0500000US39137,Putnam County,34451,2229,32222,31677,31427,100,25,61,3,61,545,0.163,0.040,0.325,4.0%,32.5%
0500000US39139,39139,39,139,"Richland County, Ohio",124475,1732,122743,120541,107726,11612,218,800,32,153,2202,0.242,0500000US39139,Richland County,124936,2615,122321,116961,104231,11216,192,791,58,473,5360,0.294,0.052,0.214,5.2%,21.4%
0500000US39141,39141,39,141,"Ross County, Ohio",78064,748,77316,75802,70378,4804,212,295,7,106,1514,0.183,0500000US39141,Ross County,77093,1031,76062,72484,67705,4005,189,369,20,196,3578,0.224,0.041,0.223,4.1%,22.3%
0500000US39143,39143,39,143,"Sandusky County, Ohio",60944,5435,55509,54498,52527,1624,96,185,7,59,1011,0.248,0500000US39143,Sandusky County,58896,6055,52841,50424,48219,1762,75,202,7,159,2417,0.317,0.068,0.275,6.8%,27.5%
0500000US39145,39145,39,145,"Scioto County, Ohio",79499,888,78611,77350,74531,2107,395,248,10,59,1261,0.120,0500000US39145,Scioto County,74008,1052,72956,70316,67531,2038,254,274,9,210,2640,0.165,0.045,0.376,4.5%,37.6%
0500000US39147,39147,39,147,"Seneca County, Ohio",56745,2524,54221,53428,51739,1227,84,321,6,51,793,0.166,0500000US39147,Seneca County,55069,2899,52170,50146,48213,1314,66,359,36,158,2024,0.229,0.063,0.378,6.3%,37.8%
0500000US39149,39149,39,149,"Shelby County, Ohio",49423,661,48762,47941,46423,928,76,421,48,45,821,0.117,0500000US39149,Shelby County,48230,787,47443,45654,44067,839,81,450,29,188,1789,0.163,0.046,0.396,4.6%,39.6%
0500000US39151,39151,39,151,"Stark County, Ohio",375586,5965,369621,361934,329497,28272,808,2736,63,558,7687,0.224,0500000US39151,Stark County,374853,10516,364337,344902,310535,28723,721,3175,97,1651,19435,0.304,0.080,0.359,8.0%,35.9%
0500000US39153,39153,39,153,"Summit County, Ohio",541781,8660,533121,522612,431624,77373,901,11841,118,755,10509,0.344,0500000US39153,Summit County,540428,13206,527222,501986,397536,78922,777,22506,149,2096,25236,0.433,0.089,0.260,8.9%,26.0%
0500000US39155,39155,39,155,"Trumbull County, Ohio",210312,2801,207511,204145,185388,17200,326,979,36,216,3366,0.216,0500000US39155,Trumbull County,201977,4179,197798,188550,169627,16940,249,1099,26,609,9248,0.285,0.069,0.321,6.9%,32.1%
0500000US39157,39157,39,157,"Tuscarawas County, Ohio",92582,1767,90815,89841,88614,696,133,286,72,40,974,0.083,0500000US39157,Tuscarawas County,93263,3962,89301,86297,84979,697,117,306,29,169,3004,0.167,0.084,1.002,8.4%,100.2%
0500000US39159,39159,39,159,"Union County, Ohio",52300,661,51639,50961,48169,1202,110,1419,16,45,678,0.150,0500000US39159,Union County,62784,1534,61250,58899,53287,1275,93,4043,0,201,2351,0.273,0.123,0.819,12.3%,81.9%
0500000US39161,39161,39,161,"Van Wert County, Ohio",28744,740,28004,27704,27351,237,36,65,2,13,300,0.094,0500000US39161,Van Wert County,28931,1097,27834,26941,26467,257,37,88,13,79,893,0.161,0.067,0.713,6.7%,71.3%
0500000US39163,39163,39,163,"Vinton County, Ohio",13435,71,13364,13214,13103,37,46,23,1,4,150,0.049,0500000US39163,Vinton County,12800,84,12716,12311,12213,43,19,22,0,14,405,0.089,0.040,0.821,4.0%,82.1%
0500000US39165,39165,39,165,"Warren County, Ohio",212693,4784,207909,205058,189305,6838,289,8261,93,272,2851,0.205,0500000US39165,Warren County,242337,7738,234599,224830,198227,8175,288,17278,158,704,9769,0.322,0.117,0.574,11.7%,57.4%
0500000US39167,39167,39,167,"Washington County, Ohio",61778,461,61317,60464,59281,657,128,341,9,48,853,0.079,0500000US39167,Washington County,59771,717,59054,56852,55663,600,114,309,8,158,2202,0.131,0.052,0.663,5.2%,66.3%
0500000US39169,39169,39,169,"Wayne County, Ohio",114520,1800,112720,111283,108450,1689,152,864,22,106,1437,0.103,0500000US39169,Wayne County,116894,2755,114139,110092,106930,1755,142,950,32,283,4047,0.161,0.059,0.572,5.9%,57.2%
0500000US39171,39171,39,171,"Williams County, Ohio",37642,1390,36252,35939,35283,358,65,212,7,14,313,0.120,0500000US39171,Williams County,37102,1862,35240,34151,33483,323,55,198,0,92,1089,0.182,0.062,0.519,6.2%,51.9%
0500000US39173,39173,39,173,"Wood County, Ohio",125488,5663,119825,118217,113021,2906,232,1924,30,104,1608,0.186,0500000US39173,Wood County,132248,8280,123968,118835,112493,3089,164,2750,9,330,5133,0.270,0.084,0.453,8.4%,45.3%
0500000US39175,39175,39,175,"Wyandot County, Ohio",22615,504,22111,21937,21727,42,27,133,4,4,174,0.076,0500000US39175,Wyandot County,21900,641,21259,20751,20520,77,21,85,3,45,508,0.121,0.044,0.579,4.4%,57.9%
0500000US40001,40001,40,1,"Adair County, Oklahoma",22683,1197,21486,19276,9558,53,9528,129,1,7,2210,0.634,0500000US40001,Adair County,19495,1252,18243,15930,7464,40,8240,162,12,12,2313,0.656,0.023,0.036,2.3%,3.6%
0500000US40003,40003,40,3,"Alfalfa County, Oklahoma",5642,224,5418,5310,4923,224,151,11,0,1,108,0.234,0500000US40003,Alfalfa County,5699,279,5420,5139,4702,229,194,7,0,7,281,0.312,0.077,0.330,7.7%,33.0%
0500000US40005,40005,40,5,"Atoka County, Oklahoma",14182,409,13773,12816,10318,527,1902,55,7,7,957,0.446,0500000US40005,Atoka County,14143,548,13595,12171,9303,565,2192,49,4,58,1424,0.530,0.084,0.189,8.4%,18.9%
0500000US40007,40007,40,7,"Beaver County, Oklahoma",5636,1135,4501,4412,4313,31,55,7,0,6,89,0.373,0500000US40007,Beaver County,5049,1304,3745,3549,3497,3,29,11,6,3,196,0.452,0.079,0.210,7.9%,21.0%
0500000US40009,40009,40,9,"Beckham County, Oklahoma",22119,2619,19500,19062,17459,842,565,173,2,21,438,0.360,0500000US40009,Beckham County,22410,2684,19726,18593,16526,1119,770,128,12,38,1133,0.436,0.075,0.209,7.5%,20.9%
0500000US40011,40011,40,11,"Blaine County, Oklahoma",11943,2873,9070,8735,7512,298,900,21,2,2,335,0.539,0500000US40011,Blaine County,8735,985,7750,7189,6248,248,650,26,5,12,561,0.465,-0.074,-0.138,-7.4%,-13.8%
0500000US40013,40013,40,13,"Bryan County, Oklahoma",42416,2107,40309,37543,31294,640,5366,214,11,18,2766,0.433,0500000US40013,Bryan County,46067,3428,42639,37737,30076,715,6574,285,14,73,4902,0.536,0.104,0.239,10.4%,23.9%
0500000US40015,40015,40,15,"Caddo County, Oklahoma",29600,2995,26605,25137,17618,804,6621,72,10,12,1468,0.582,0500000US40015,Caddo County,26945,4335,22610,20651,14580,646,5320,63,13,29,1959,0.636,0.054,0.093,5.4%,9.3%
0500000US40017,40017,40,17,"Canadian County, Oklahoma",115541,7794,107747,103780,92120,2820,5240,3459,59,82,3967,0.355,0500000US40017,Canadian County,154405,16377,138028,124891,107898,5307,6312,4782,114,478,13137,0.489,0.134,0.378,13.4%,37.8%
0500000US40019,40019,40,19,"Carter County, Oklahoma",47557,2528,45029,42241,34498,3134,4080,502,8,19,2788,0.456,0500000US40019,Carter County,48003,3622,44381,39540,31227,2824,4203,587,44,655,4841,0.549,0.094,0.206,9.4%,20.6%
0500000US40021,40021,40,21,"Cherokee County, Oklahoma",46987,2952,44035,40024,23591,582,15572,250,14,15,4011,0.627,0500000US40021,Cherokee County,47078,3437,43641,36963,20231,519,15745,308,21,139,6678,0.678,0.051,0.082,5.1%,8.2%
0500000US40023,40023,40,23,"Choctaw County, Oklahoma",15205,427,14778,13834,9693,1654,2447,38,0,2,944,0.551,0500000US40023,Choctaw County,14204,595,13609,12077,8114,1371,2502,29,4,57,1532,0.620,0.069,0.125,6.9%,12.5%
0500000US40025,40025,40,25,"Cimarron County, Oklahoma",2475,514,1961,1927,1894,6,19,7,0,1,34,0.371,0500000US40025,Cimarron County,2296,563,1733,1659,1647,1,4,0,0,7,74,0.424,0.053,0.144,5.3%,14.4%
0500000US40027,40027,40,27,"Cleveland County, Oklahoma",255755,17892,237863,225547,193549,10572,11375,9626,166,259,12316,0.415,0500000US40027,Cleveland County,295528,30312,265216,236631,195085,14613,12133,12697,237,1866,28585,0.538,0.123,0.297,12.3%,29.7%
0500000US40029,40029,40,29,"Coal County, Oklahoma",5925,152,5773,5329,4329,25,964,10,0,1,444,0.433,0500000US40029,Coal County,5266,198,5068,4466,3371,23,1009,15,0,48,602,0.539,0.105,0.243,10.5%,24.3%
0500000US40031,40031,40,31,"Comanche County, Oklahoma",124098,13896,110202,103960,73122,20794,6597,2663,635,149,6242,0.606,0500000US40031,Comanche County,121125,16645,104480,94040,64465,18871,6381,2994,803,526,10440,0.663,0.056,0.093,5.6%,9.3%
0500000US40033,40033,40,33,"Cotton County, Oklahoma",6193,344,5849,5559,4905,126,504,12,11,1,290,0.360,0500000US40033,Cotton County,5527,361,5166,4693,4098,68,481,28,9,9,473,0.431,0.071,0.196,7.1%,19.6%
0500000US40035,40035,40,35,"Craig County, Oklahoma",15029,370,14659,13427,9852,440,3010,105,16,4,1232,0.522,0500000US40035,Craig County,14107,427,13680,11746,8438,368,2833,75,1,31,1934,0.581,0.060,0.114,6.0%,11.4%
0500000US40037,40037,40,37,"Creek County, Oklahoma",69967,2152,67815,63494,54821,1528,6834,230,43,38,4321,0.371,0500000US40037,Creek County,71754,3412,68342,60480,51528,1452,7002,290,67,141,7862,0.460,0.089,0.239,8.9%,23.9%
0500000US40039,40039,40,39,"Custer County, Oklahoma",27469,3830,23639,22905,20169,794,1642,276,7,17,734,0.436,0500000US40039,Custer County,28513,5384,23129,21320,18483,783,1702,294,1,57,1809,0.536,0.099,0.228,9.9%,22.8%
0500000US40041,40041,40,41,"Delaware County, Oklahoma",41487,1248,40239,37113,27328,83,9145,514,30,13,3126,0.511,0500000US40041,Delaware County,40397,1621,38776,34218,25019,116,8491,471,36,85,4558,0.558,0.047,0.092,4.7%,9.2%
0500000US40043,40043,40,43,"Dewey County, Oklahoma",4810,231,4579,4447,4136,16,261,33,0,1,132,0.255,0500000US40043,Dewey County,4484,260,4224,3987,3723,7,247,4,2,4,237,0.301,0.047,0.184,4.7%,18.4%
0500000US40045,40045,40,45,"Ellis County, Oklahoma",4151,251,3900,3852,3759,11,67,8,0,7,48,0.176,0500000US40045,Ellis County,3749,340,3409,3233,3148,16,57,9,0,3,176,0.284,0.108,0.616,10.8%,61.6%
0500000US40047,40047,40,47,"Garfield County, Oklahoma",60580,5353,55227,53522,48744,1765,1280,577,1094,62,1705,0.342,0500000US40047,Garfield County,62846,8982,53864,49662,42939,1661,1307,685,2920,150,4202,0.505,0.163,0.475,16.3%,47.5%
0500000US40049,40049,40,49,"Garvin County, Oklahoma",27576,1713,25863,24683,21791,690,2091,102,6,3,1180,0.363,0500000US40049,Garvin County,25656,2452,23204,20976,18200,545,2066,118,8,39,2228,0.473,0.110,0.302,11.0%,30.2%
0500000US40051,40051,40,51,"Grady County, Oklahoma",52431,2405,50026,48015,43853,1239,2675,192,33,23,2011,0.294,0500000US40051,Grady County,54795,3520,51275,46370,41842,1281,2897,200,38,112,4905,0.401,0.108,0.367,10.8%,36.7%
0500000US40053,40053,40,53,"Grant County, Oklahoma",4527,158,4369,4272,4142,35,84,9,1,1,97,0.161,0500000US40053,Grant County,4169,184,3985,3790,3632,44,79,12,8,15,195,0.236,0.076,0.470,7.6%,47.0%
0500000US40055,40055,40,55,"Greer County, Oklahoma",6239,609,5630,5502,4894,438,152,10,6,2,128,0.369,0500000US40055,Greer County,5491,665,4826,4538,3996,352,167,7,1,15,288,0.448,0.079,0.213,7.9%,21.3%
0500000US40057,40057,40,57,"Harmon County, Oklahoma",2922,756,2166,2087,1839,197,39,12,0,0,79,0.531,0500000US40057,Harmon County,2488,740,1748,1612,1403,149,53,7,0,0,136,0.587,0.055,0.104,5.5%,10.4%
0500000US40059,40059,40,59,"Harper County, Oklahoma",3685,645,3040,2993,2957,2,27,6,1,0,47,0.325,0500000US40059,Harper County,3272,733,2539,2405,2375,4,24,0,0,2,134,0.421,0.096,0.295,9.6%,29.5%
0500000US40061,40061,40,61,"Haskell County, Oklahoma",12769,426,12343,11481,9362,51,1994,68,2,4,862,0.432,0500000US40061,Haskell County,11561,529,11032,9968,7697,64,2153,21,7,26,1064,0.511,0.079,0.183,7.9%,18.3%
0500000US40063,40063,40,63,"Hughes County, Oklahoma",14003,530,13473,12620,9351,739,2489,27,6,8,853,0.515,0500000US40063,Hughes County,13367,755,12612,11404,8073,728,2513,38,14,38,1208,0.586,0.071,0.138,7.1%,13.8%
0500000US40065,40065,40,65,"Jackson County, Oklahoma",26446,5538,20908,20121,17403,1918,407,303,52,38,787,0.517,0500000US40065,Jackson County,24785,5937,18848,17333,14883,1614,382,320,77,57,1515,0.574,0.057,0.110,5.7%,11.0%
0500000US40067,40067,40,67,"Jefferson County, Oklahoma",6472,552,5920,5658,5216,41,376,22,0,3,262,0.338,0500000US40067,Jefferson County,5337,584,4753,4328,3993,27,258,30,5,15,425,0.420,0.081,0.241,8.1%,24.1%
0500000US40069,40069,40,69,"Johnston County, Oklahoma",10957,423,10534,9732,7854,209,1636,27,1,5,802,0.457,0500000US40069,Johnston County,10272,581,9691,8667,6735,236,1582,52,5,57,1024,0.533,0.076,0.166,7.6%,16.6%
0500000US40071,40071,40,71,"Kay County, Oklahoma",46562,2992,43570,41559,36113,910,4276,233,7,20,2011,0.384,0500000US40071,Kay County,43700,3652,40048,36313,30728,856,4127,253,274,75,3735,0.482,0.098,0.256,9.8%,25.6%
0500000US40073,40073,40,73,"Kingfisher County, Oklahoma",15034,2022,13012,12675,12030,157,445,38,0,5,337,0.340,0500000US40073,Kingfisher County,15184,2755,12429,11643,10985,170,417,45,0,26,786,0.440,0.100,0.294,10.0%,29.4%
0500000US40075,40075,40,75,"Kiowa County, Oklahoma",9446,832,8614,8313,7302,390,584,29,2,6,301,0.388,0500000US40075,Kiowa County,8509,953,7556,7034,6149,314,504,47,3,17,522,0.457,0.068,0.176,6.8%,17.6%
0500000US40077,40077,40,77,"Latimer County, Oklahoma",11154,293,10861,10047,7718,80,2215,31,1,2,814,0.476,0500000US40077,Latimer County,9444,344,9100,8164,5818,42,2216,67,5,16,936,0.554,0.079,0.165,7.9%,16.5%
0500000US40079,40079,40,79,"Le Flore County, Oklahoma",50384,3454,46930,44221,36842,1016,6070,258,21,14,2709,0.443,0500000US40079,Le Flore County,48129,3573,44556,40025,31920,841,6890,292,32,50,4531,0.525,0.082,0.186,8.2%,18.6%
0500000US40081,40081,40,81,"Lincoln County, Oklahoma",34273,838,33435,31847,28985,608,2170,64,12,8,1588,0.278,0500000US40081,Lincoln County,33458,1137,32321,29225,26146,592,2282,114,13,78,3096,0.375,0.097,0.349,9.7%,34.9%
0500000US40083,40083,40,83,"Logan County, Oklahoma",41848,2170,39678,38185,32864,3752,1333,189,19,28,1493,0.370,0500000US40083,Logan County,49555,4003,45552,41403,36060,3201,1613,260,31,238,4149,0.452,0.081,0.220,8.1%,22.0%
0500000US40085,40085,40,85,"Love County, Oklahoma",9423,1113,8310,7956,7186,163,561,45,0,1,354,0.399,0500000US40085,Love County,10146,1685,8461,7750,6806,196,613,72,0,63,711,0.513,0.114,0.286,11.4%,28.6%
0500000US40087,40087,40,87,"McClain County, Oklahoma",34506,2400,32106,30455,27942,229,2142,127,6,9,1651,0.333,0500000US40087,McClain County,41662,3699,37963,34045,30701,346,2653,209,36,100,3918,0.436,0.103,0.309,10.3%,30.9%
0500000US40089,40089,40,89,"McCurtain County, Oklahoma",33151,1552,31599,29699,21829,2872,4868,112,3,15,1900,0.532,0500000US40089,McCurtain County,30814,1894,28920,25611,18159,2538,4290,124,460,40,3309,0.611,0.079,0.149,7.9%,14.9%
0500000US40091,40091,40,91,"McIntosh County, Oklahoma",20252,390,19862,18477,14053,642,3704,68,7,3,1385,0.479,0500000US40091,McIntosh County,18941,491,18450,16482,12644,547,3163,68,4,56,1968,0.514,0.035,0.073,3.5%,7.3%
0500000US40093,40093,40,93,"Major County, Oklahoma",7527,565,6962,6820,6629,32,130,25,3,1,142,0.218,0500000US40093,Major County,7782,784,6998,6674,6479,15,131,40,0,9,324,0.295,0.077,0.351,7.7%,35.1%
0500000US40095,40095,40,95,"Marshall County, Oklahoma",15840,2212,13628,12801,11050,227,1492,29,1,2,827,0.482,0500000US40095,Marshall County,15312,2605,12707,11464,9749,169,1413,44,4,85,1243,0.550,0.068,0.142,6.8%,14.2%
0500000US40097,40097,40,97,"Mayes County, Oklahoma",41259,1097,40162,36601,27590,161,8678,144,14,14,3561,0.500,0500000US40097,Mayes County,39046,1375,37671,32060,23516,180,8095,192,27,50,5611,0.572,0.072,0.144,7.2%,14.4%
0500000US40099,40099,40,99,"Murray County, Oklahoma",13488,662,12826,12043,10241,176,1570,47,3,6,783,0.404,0500000US40099,Murray County,13904,926,12978,11615,9446,153,1936,45,19,16,1363,0.505,0.101,0.250,10.1%,25.0%
0500000US40101,40101,40,101,"Muskogee County, Oklahoma",70990,3688,67302,61884,41362,7960,12137,381,20,24,5418,0.610,0500000US40101,Muskogee County,66339,4499,61840,53865,34857,6545,11747,512,39,165,7975,0.664,0.054,0.088,5.4%,8.8%
0500000US40103,40103,40,103,"Noble County, Oklahoma",11561,300,11261,10831,9626,202,948,45,7,3,430,0.298,0500000US40103,Noble County,10924,420,10504,9589,8414,145,953,47,0,30,915,0.390,0.093,0.312,9.3%,31.2%
0500000US40105,40105,40,105,"Nowata County, Oklahoma",10536,240,10296,9350,7148,202,1987,7,3,3,946,0.495,0500000US40105,Nowata County,9320,241,9079,7496,5812,104,1562,5,5,8,1583,0.553,0.058,0.117,5.8%,11.7%
0500000US40107,40107,40,107,"Okfuskee County, Oklahoma",12191,356,11835,11094,7699,1001,2358,18,15,3,741,0.552,0500000US40107,Okfuskee County,11310,342,10968,9908,6590,694,2559,32,0,33,1060,0.596,0.043,0.078,4.3%,7.8%
0500000US40109,40109,40,109,"Oklahoma County, Oklahoma",718633,108543,610090,579918,425791,108954,22527,21151,639,856,30172,0.600,0500000US40109,Oklahoma County,796292,153498,642794,580119,407986,117957,22034,27823,1168,3151,62675,0.670,0.071,0.118,7.1%,11.8%
0500000US40111,40111,40,111,"Okmulgee County, Oklahoma",40069,1293,38776,35774,25803,3459,6358,126,6,22,3002,0.546,0500000US40111,Okmulgee County,36706,1708,34998,30552,21599,2742,5947,160,22,82,4446,0.605,0.059,0.108,5.9%,10.8%
0500000US40113,40113,40,113,"Osage County, Oklahoma",47472,1366,46106,42911,30709,5355,6704,118,11,14,3195,0.544,0500000US40113,Osage County,45818,1872,43946,38887,27443,4796,6405,128,19,96,5059,0.597,0.053,0.098,5.3%,9.8%
0500000US40115,40115,40,115,"Ottawa County, Oklahoma",31848,1499,30349,28066,21454,234,5893,158,297,30,2283,0.504,0500000US40115,Ottawa County,30285,1708,28577,25135,18850,287,5563,154,231,50,3442,0.563,0.058,0.115,5.8%,11.5%
0500000US40117,40117,40,117,"Pawnee County, Oklahoma",16577,336,16241,15298,13216,116,1908,42,6,10,943,0.347,0500000US40117,Pawnee County,15553,467,15086,13621,11530,73,1927,49,0,42,1465,0.425,0.078,0.224,7.8%,22.4%
0500000US40119,40119,40,119,"Payne County, Oklahoma",77350,2990,74360,70690,61655,2757,3494,2679,34,71,3670,0.356,0500000US40119,Payne County,81646,5373,76273,68673,58926,3123,3613,2662,53,296,7600,0.462,0.105,0.295,10.5%,29.5%
0500000US40121,40121,40,121,"Pittsburg County, Oklahoma",45837,1786,44051,40821,32959,1497,6148,185,19,13,3230,0.457,0500000US40121,Pittsburg County,43773,2266,41507,36380,28388,1227,6388,280,35,62,5127,0.541,0.083,0.182,8.3%,18.2%
0500000US40123,40123,40,123,"Pontotoc County, Oklahoma",37492,1523,35969,33456,25973,879,6331,244,17,12,2513,0.485,0500000US40123,Pontotoc County,38065,2208,35857,30889,22703,861,6842,372,13,98,4968,0.591,0.106,0.219,10.6%,21.9%
0500000US40125,40125,40,125,"Pottawatomie County, Oklahoma",69442,2878,66564,62615,51642,1969,8538,373,40,53,3949,0.426,0500000US40125,Pottawatomie County,72454,4288,68166,60750,49158,2194,8693,495,39,171,7416,0.510,0.084,0.198,8.4%,19.8%
0500000US40127,40127,40,127,"Pushmataha County, Oklahoma",11572,280,11292,10670,8550,74,2017,25,3,1,622,0.420,0500000US40127,Pushmataha County,10812,376,10436,9353,7382,66,1830,52,0,23,1083,0.494,0.074,0.175,7.4%,17.5%
0500000US40129,40129,40,129,"Roger Mills County, Oklahoma",3647,165,3482,3409,3184,13,199,11,1,1,73,0.232,0500000US40129,Roger Mills County,3442,256,3186,2978,2860,5,106,5,1,1,208,0.299,0.067,0.289,6.7%,28.9%
0500000US40131,40131,40,131,"Rogers County, Oklahoma",86905,3229,83676,77046,64030,819,11191,914,49,43,6630,0.433,0500000US40131,Rogers County,95240,5257,89983,77600,62387,1103,12109,1676,39,286,12383,0.534,0.101,0.234,10.1%,23.4%
0500000US40133,40133,40,133,"Seminole County, Oklahoma",25482,903,24579,22888,17133,1152,4500,65,16,22,1691,0.509,0500000US40133,Seminole County,23556,1176,22380,19609,14109,920,4411,72,8,89,2771,0.588,0.079,0.156,7.9%,15.6%
0500000US40135,40135,40,135,"Sequoyah County, Oklahoma",42391,1438,40953,37233,27634,718,8657,199,9,16,3720,0.524,0500000US40135,Sequoyah County,39281,1726,37555,32448,22497,585,8954,288,14,110,5107,0.601,0.077,0.146,7.7%,14.6%
0500000US40137,40137,40,137,"Stephens County, Oklahoma",45048,2790,42258,40429,37173,841,2182,210,13,10,1829,0.311,0500000US40137,Stephens County,42848,3452,39396,35616,32383,799,2034,244,13,143,3780,0.412,0.101,0.325,10.1%,32.5%
0500000US40139,40139,40,139,"Texas County, Oklahoma",20640,8659,11981,11722,10889,294,183,318,9,29,259,0.545,0500000US40139,Texas County,21384,10823,10561,9916,8263,975,162,448,0,68,645,0.591,0.046,0.084,4.6%,8.4%
0500000US40141,40141,40,141,"Tillman County, Oklahoma",7992,1783,6209,6011,5165,567,243,21,2,13,198,0.526,0500000US40141,Tillman County,6968,1923,5045,4698,3982,474,191,26,0,25,347,0.589,0.063,0.121,6.3%,12.1%
0500000US40143,40143,40,143,"Tulsa County, Oklahoma",603403,66582,536821,506656,393401,63737,34615,13892,383,628,30165,0.545,0500000US40143,Tulsa County,669279,100049,569230,502941,371913,66182,36612,24846,1033,2355,66289,0.645,0.100,0.183,10.0%,18.3%
0500000US40145,40145,40,145,"Wagoner County, Oklahoma",73085,3488,69597,64510,53648,2669,7119,995,25,54,5087,0.443,0500000US40145,Wagoner County,80981,6137,74844,65104,52734,2638,8073,1405,29,225,9740,0.544,0.101,0.229,10.1%,22.9%
0500000US40147,40147,40,147,"Washington County, Oklahoma",50976,2556,48420,45602,38691,1194,5119,552,16,30,2818,0.408,0500000US40147,Washington County,52455,3360,49095,42829,35208,1322,5194,974,10,121,6266,0.520,0.113,0.277,11.3%,27.7%
0500000US40149,40149,40,149,"Washita County, Oklahoma",11629,944,10685,10409,9989,71,320,24,2,3,276,0.254,0500000US40149,Washita County,10924,980,9944,9237,8818,77,303,22,0,17,707,0.335,0.081,0.319,8.1%,31.9%
0500000US40151,40151,40,151,"Woods County, Oklahoma",8878,424,8454,8257,7684,286,202,77,4,4,197,0.246,0500000US40151,Woods County,8624,613,8011,7583,7025,228,240,74,1,15,428,0.327,0.081,0.328,8.1%,32.8%
0500000US40153,40153,40,153,"Woodward County, Oklahoma",20081,2128,17953,17605,16632,308,522,115,8,20,348,0.302,0500000US40153,Woodward County,20470,3006,17464,16503,15426,351,543,126,0,57,961,0.407,0.106,0.351,10.6%,35.1%
0500000US41001,41001,41,1,"Baker County, Oregon",16134,528,15606,15260,14944,52,170,78,9,7,346,0.140,0500000US41001,Baker County,16668,809,15859,15083,14664,70,172,64,15,98,776,0.221,0.081,0.576,8.1%,57.6%
0500000US41003,41003,41,3,"Benton County, Oregon",85579,5467,80112,77519,71552,715,493,4404,199,156,2593,0.293,0500000US41003,Benton County,95184,8524,86660,80864,72209,938,528,6375,276,538,5796,0.408,0.115,0.392,11.5%,39.2%
0500000US41005,41005,41,5,"Clackamas County, Oregon",375992,29138,346854,337577,317648,2761,2340,13575,815,438,9277,0.278,0500000US41005,Clackamas County,421401,40342,381059,355619,325361,4336,2249,20459,1056,2158,25440,0.389,0.110,0.396,11.0%,39.6%
0500000US41007,41007,41,7,"Clatsop County, Oregon",37039,2838,34201,33343,32295,163,308,445,84,48,858,0.233,0500000US41007,Clatsop County,41072,3848,37224,34968,33526,224,344,552,91,231,2256,0.322,0.088,0.380,8.8%,38.0%
0500000US41009,41009,41,9,"Columbia County, Oregon",49351,1987,47364,45932,44563,195,590,446,95,43,1432,0.182,0500000US41009,Columbia County,52589,3070,49519,46091,44228,300,618,561,117,267,3428,0.285,0.103,0.565,10.3%,56.5%
0500000US41011,41011,41,11,"Coos County, Oregon",63043,3391,59652,57344,54820,234,1467,644,104,75,2308,0.239,0500000US41011,Coos County,64929,4292,60637,56281,53538,259,1320,728,120,316,4356,0.311,0.072,0.300,7.2%,30.0%
0500000US41013,41013,41,13,"Crook County, Oregon",20978,1463,19515,19180,18758,30,273,96,11,12,335,0.195,0500000US41013,Crook County,24738,1803,22935,21453,20874,78,262,114,23,102,1482,0.279,0.084,0.429,8.4%,42.9%
0500000US41015,41015,41,15,"Curry County, Oregon",22364,1201,21163,20484,19837,62,391,157,21,16,679,0.209,0500000US41015,Curry County,23446,1674,21772,20330,19428,77,461,214,25,125,1442,0.304,0.095,0.454,9.5%,45.4%
0500000US41017,41017,41,17,"Deschutes County, Oregon",157733,11718,146015,142927,139470,524,1197,1412,183,141,3088,0.212,0500000US41017,Deschutes County,198253,17237,181016,170227,164595,786,1139,2421,258,1028,10789,0.300,0.088,0.414,8.8%,41.4%
0500000US41019,41019,41,19,"Douglas County, Oregon",107667,5055,102612,99693,96343,279,1799,1008,110,154,2919,0.196,0500000US41019,Douglas County,111201,6654,104547,97470,93525,383,1694,1185,151,532,7077,0.285,0.089,0.452,8.9%,45.2%
0500000US41021,41021,41,21,"Gilliam County, Oregon",1871,88,1783,1762,1725,3,18,3,13,0,21,0.147,0500000US41021,Gilliam County,1995,107,1888,1797,1747,3,29,6,9,3,91,0.228,0.080,0.546,8.0%,54.6%
0500000US41023,41023,41,23,"Grant County, Oregon",7445,207,7238,7082,6951,11,88,24,6,2,156,0.127,0500000US41023,Grant County,7233,283,6950,6550,6430,10,58,23,10,19,400,0.205,0.078,0.615,7.8%,61.5%
0500000US41025,41025,41,25,"Harney County, Oregon",7422,294,7128,6932,6648,16,227,34,1,6,196,0.194,0500000US41025,Harney County,7495,394,7101,6716,6435,5,219,36,0,21,385,0.257,0.062,0.319,6.2%,31.9%
0500000US41027,41027,41,27,"Hood River County, Oregon",22346,6589,15757,15281,14714,63,144,305,30,25,476,0.479,0500000US41027,Hood River County,23977,7148,16829,15664,14935,47,149,381,33,119,1165,0.520,0.042,0.087,4.2%,8.7%
0500000US41029,41029,41,29,"Jackson County, Oregon",203206,21745,181461,176219,170023,1227,1874,2304,562,229,5242,0.288,0500000US41029,Jackson County,223259,30399,192860,179178,170232,1574,1775,3293,808,1496,13682,0.396,0.108,0.377,10.8%,37.7%
0500000US41031,41031,41,31,"Jefferson County, Oregon",21720,4195,17525,17046,13429,117,3360,83,23,34,479,0.556,0500000US41031,Jefferson County,24502,5002,19500,18335,15005,134,2981,131,18,66,1165,0.566,0.010,0.018,1.0%,1.8%
0500000US41033,41033,41,33,"Josephine County, Oregon",82713,5251,77462,75411,73289,295,966,667,117,77,2051,0.210,0500000US41033,Josephine County,88090,7037,81053,75467,72730,368,883,870,123,493,5586,0.308,0.098,0.465,9.8%,46.5%
0500000US41035,41035,41,35,"Klamath County, Oregon",66380,6915,59465,57369,53822,394,2407,615,68,63,2096,0.329,0500000US41035,Klamath County,69413,8772,60641,56163,51919,497,2493,754,104,396,4478,0.419,0.090,0.272,9.0%,27.2%
0500000US41037,41037,41,37,"Lake County, Oregon",7895,545,7350,7117,6875,37,149,44,5,7,233,0.236,0500000US41037,Lake County,8160,802,7358,6775,6508,49,114,52,10,42,583,0.349,0.113,0.480,11.3%,48.0%
0500000US41039,41039,41,39,"Lane County, Oregon",351715,26167,325548,313743,297808,3102,3418,8169,732,514,11805,0.276,0500000US41039,Lane County,382971,37780,345191,318942,298507,4352,3355,9404,947,2377,26249,0.377,0.102,0.368,10.2%,36.8%
0500000US41041,41041,41,41,"Lincoln County, Oregon",46034,3655,42379,41025,38863,159,1433,482,52,36,1354,0.279,0500000US41041,Lincoln County,50395,4851,45544,42223,39498,189,1521,646,93,276,3321,0.371,0.092,0.330,9.2%,33.0%
0500000US41043,41043,41,43,"Linn County, Oregon",116672,9127,107545,104657,101579,456,1268,1078,150,126,2888,0.235,0500000US41043,Linn County,128610,12571,116039,108396,104118,623,1283,1434,280,658,7643,0.331,0.096,0.409,9.6%,40.9%
0500000US41045,41045,41,45,"Malheur County, Oregon",31313,9867,21446,21016,19906,331,235,511,12,21,430,0.496,0500000US41045,Malheur County,31571,10320,21251,20257,18975,447,295,385,40,115,994,0.530,0.035,0.070,3.5%,7.0%
0500000US41047,41047,41,47,"Marion County, Oregon",315335,76594,238741,231409,216758,2906,3290,5790,2254,411,7332,0.467,0500000US41047,Marion County,345920,95740,250180,233201,213650,3787,3124,7270,3669,1701,16979,0.539,0.071,0.153,7.1%,15.3%
0500000US41049,41049,41,49,"Morrow County, Oregon",11173,3497,7676,7495,7218,36,112,100,13,16,181,0.484,0500000US41049,Morrow County,12186,4988,7198,6797,6600,37,82,29,5,44,401,0.538,0.054,0.111,5.4%,11.1%
0500000US41051,41051,41,51,"Multnomah County, Oregon",735334,80138,655196,628647,530303,39919,5527,47508,3870,1520,26549,0.460,0500000US41051,Multnomah County,815428,103753,711675,656287,535623,43793,5455,61280,5251,4885,55388,0.539,0.080,0.173,8.0%,17.3%
0500000US41053,41053,41,53,"Polk County, Oregon",75403,9088,66315,64159,60702,394,1380,1403,201,79,2156,0.336,0500000US41053,Polk County,87433,12730,74703,69438,64719,682,1579,1702,344,412,5265,0.426,0.091,0.270,9.1%,27.0%
0500000US41055,41055,41,55,"Sherman County, Oregon",1765,98,1667,1649,1616,2,21,3,1,6,18,0.158,0500000US41055,Sherman County,1870,119,1751,1639,1610,0,19,7,0,3,112,0.251,0.093,0.585,9.3%,58.5%
0500000US41057,41057,41,57,"Tillamook County, Oregon",25250,2284,22966,22488,21902,62,220,223,56,25,478,0.239,0500000US41057,Tillamook County,27390,2946,24444,22821,22000,76,239,280,85,141,1623,0.340,0.101,0.421,10.1%,42.1%
0500000US41059,41059,41,59,"Umatilla County, Oregon",75889,18107,57782,56407,52691,557,2383,626,95,55,1375,0.460,0500000US41059,Umatilla County,80075,22622,57453,54086,49753,652,2571,685,130,295,3367,0.531,0.072,0.156,7.2%,15.6%
0500000US41061,41061,41,61,"Union County, Oregon",25748,1002,24746,24264,23407,126,255,204,223,49,482,0.171,0500000US41061,Union County,26196,1347,24849,23272,22075,145,219,216,488,129,1577,0.283,0.112,0.651,11.2%,65.1%
0500000US41063,41063,41,63,"Wallowa County, Oregon",7008,156,6852,6726,6625,26,38,24,6,7,126,0.105,0500000US41063,Wallowa County,7391,257,7134,6746,6598,9,50,31,4,54,388,0.199,0.094,0.887,9.4%,88.7%
0500000US41065,41065,41,65,"Wasco County, Oregon",25213,3743,21470,21008,19556,85,1018,191,142,16,462,0.374,0500000US41065,Wasco County,26670,5017,21653,20344,18703,115,983,248,185,110,1309,0.469,0.095,0.253,9.5%,25.3%
0500000US41067,41067,41,67,"Washington County, Oregon",529710,83270,446440,429436,369453,8861,2559,45354,2269,940,17004,0.480,0500000US41067,Washington County,600372,107642,492730,455177,365232,12763,2416,68430,3240,3096,37553,0.580,0.100,0.209,10.0%,20.9%
0500000US41069,41069,41,69,"Wheeler County, Oregon",1441,62,1379,1338,1307,0,16,8,2,5,41,0.175,0500000US41069,Wheeler County,1451,84,1367,1283,1256,1,17,8,0,1,84,0.244,0.069,0.397,6.9%,39.7%
0500000US41071,41071,41,71,"Yamhill County, Oregon",99193,14592,84601,82228,78448,784,1272,1418,163,143,2373,0.352,0500000US41071,Yamhill County,107722,17793,89929,83874,79352,849,1346,1523,189,615,6055,0.426,0.075,0.212,7.5%,21.2%
0500000US42001,42001,42,1,"Adams County, Pennsylvania",101407,6115,95292,94262,91830,1450,146,737,20,79,1030,0.176,0500000US42001,Adams County,103852,7790,96062,92883,89945,1473,147,952,33,333,3179,0.243,0.067,0.381,6.7%,38.1%
0500000US42003,42003,42,3,"Allegheny County, Pennsylvania",1223348,19070,1204278,1183929,986212,159998,1426,33944,251,2098,20349,0.332,0500000US42003,Allegheny County,1250578,34325,1216253,1165797,938252,161554,1305,58318,304,6064,50456,0.416,0.084,0.254,8.4%,25.4%
0500000US42005,42005,42,5,"Armstrong County, Pennsylvania",68941,366,68575,68087,67326,540,41,147,8,25,488,0.046,0500000US42005,Armstrong County,65558,490,65068,63096,62320,438,57,147,14,120,1972,0.095,0.049,1.065,4.9%,106.5%
0500000US42007,42007,42,7,"Beaver County, Pennsylvania",170539,1998,168541,165830,154196,10586,158,717,32,141,2711,0.178,0500000US42007,Beaver County,168215,3611,164604,156833,143881,11069,195,1022,53,613,7771,0.261,0.083,0.467,8.3%,46.7%
0500000US42009,42009,42,9,"Bedford County, Pennsylvania",49762,450,49312,48958,48535,236,57,101,5,24,354,0.049,0500000US42009,Bedford County,47577,519,47058,45831,45381,181,66,153,0,50,1227,0.089,0.041,0.841,4.1%,84.1%
0500000US42011,42011,42,11,"Berks County, Pennsylvania",411442,67355,344087,339135,316406,16517,536,5244,58,374,4952,0.380,0500000US42011,Berks County,428849,99550,329299,317632,291258,18087,450,6225,61,1551,11667,0.482,0.102,0.269,10.2%,26.9%
0500000US42013,42013,42,13,"Blair County, Pennsylvania",127089,1230,125859,124438,121495,2051,125,689,26,52,1421,0.086,0500000US42013,Blair County,122822,1708,121114,116860,113016,2463,134,868,12,367,4254,0.151,0.066,0.770,6.6%,77.0%
0500000US42015,42015,42,15,"Bradford County, Pennsylvania",62622,702,61920,61342,60584,269,127,330,5,27,578,0.064,0500000US42015,Bradford County,59967,873,59094,56834,55717,394,117,460,13,133,2260,0.135,0.071,1.117,7.1%,111.7%
0500000US42017,42017,42,17,"Bucks County, Pennsylvania",625249,26782,598467,590255,543207,21454,750,23893,138,813,8212,0.241,0500000US42017,Bucks County,646538,39770,606768,585091,521575,25277,531,35053,143,2512,21677,0.340,0.099,0.413,9.9%,41.3%
0500000US42019,42019,42,19,"Butler County, Pennsylvania",183862,1941,181921,180354,176259,1954,166,1826,47,102,1567,0.081,0500000US42019,Butler County,193763,3665,190098,183814,178081,2174,154,2792,36,577,6284,0.154,0.073,0.905,7.3%,90.5%
0500000US42021,42021,42,21,"Cambria County, Pennsylvania",143679,2006,141673,140104,134073,5073,108,720,28,102,1569,0.128,0500000US42021,Cambria County,133472,2465,131007,126260,119380,5665,96,764,35,320,4747,0.197,0.069,0.540,6.9%,54.0%
0500000US42023,42023,42,23,"Cameron County, Pennsylvania",5085,19,5066,5024,4985,12,13,14,0,0,42,0.039,0500000US42023,Cameron County,4547,86,4461,4332,4271,12,8,29,0,12,129,0.116,0.078,1.999,7.8%,199.9%
0500000US42025,42025,42,25,"Carbon County, Pennsylvania",65249,2145,63104,62520,61168,888,100,304,24,36,584,0.120,0500000US42025,Carbon County,64749,3642,61107,59161,57439,1070,95,327,14,216,1946,0.209,0.089,0.742,8.9%,74.2%
0500000US42027,42027,42,27,"Centre County, Pennsylvania",153990,3690,150300,148214,135427,4456,153,7934,42,202,2086,0.222,0500000US42027,Centre County,158172,5651,152521,147102,129668,5306,120,11373,39,596,5419,0.319,0.097,0.436,9.7%,43.6%
0500000US42029,42029,42,29,"Chester County, Pennsylvania",498886,32503,466383,459417,409561,29388,535,19216,117,600,6966,0.317,0500000US42029,Chester County,534413,43542,490871,471910,405476,28391,532,35143,119,2249,18961,0.409,0.093,0.293,9.3%,29.3%
0500000US42031,42031,42,31,"Clarion County, Pennsylvania",39988,245,39743,39457,38724,468,45,191,5,24,286,0.062,0500000US42031,Clarion County,37241,387,36854,35884,35023,521,39,175,15,111,970,0.115,0.053,0.849,5.3%,84.9%
0500000US42033,42033,42,33,"Clearfield County, Pennsylvania",81642,1907,79735,79201,77031,1697,51,384,15,23,534,0.109,0500000US42033,Clearfield County,80562,2637,77925,75772,73338,1760,78,450,0,146,2153,0.169,0.060,0.554,6.0%,55.4%
0500000US42035,42035,42,35,"Clinton County, Pennsylvania",39238,437,38801,38491,37618,612,29,199,15,18,310,0.080,0500000US42035,Clinton County,37450,662,36788,35688,34933,416,51,211,7,70,1100,0.129,0.048,0.599,4.8%,59.9%
0500000US42037,42037,42,37,"Columbia County, Pennsylvania",67295,1349,65946,65346,63500,1190,57,547,14,38,600,0.109,0500000US42037,Columbia County,64727,2140,62587,60693,58831,867,71,748,17,159,1894,0.172,0.063,0.578,6.3%,57.8%
0500000US42039,42039,42,39,"Crawford County, Pennsylvania",88765,823,87942,87020,84930,1503,150,397,13,27,922,0.084,0500000US42039,Crawford County,83938,1241,82697,79572,77347,1496,109,365,26,229,3125,0.149,0.065,0.772,6.5%,77.2%
0500000US42041,42041,42,41,"Cumberland County, Pennsylvania",235406,6448,228958,225361,210514,7237,293,7028,60,229,3597,0.197,0500000US42041,Cumberland County,259469,11975,247494,237912,211990,10581,318,13836,113,1074,9582,0.324,0.127,0.643,12.7%,64.3%
0500000US42043,42043,42,43,"Dauphin County, Pennsylvania",268100,18795,249305,243078,187402,46320,396,8507,44,409,6227,0.475,0500000US42043,Dauphin County,286401,31251,255150,242711,175175,48404,396,17183,88,1465,12439,0.580,0.105,0.221,10.5%,22.1%
0500000US42045,42045,42,45,"Delaware County, Pennsylvania",558979,16537,542442,533312,397424,108231,674,26144,114,725,9130,0.454,0500000US42045,Delaware County,576830,26772,550058,530026,363249,127055,676,36317,133,2596,20032,0.548,0.094,0.207,9.4%,20.7%
0500000US42047,42047,42,47,"Elk County, Pennsylvania",31946,183,31763,31576,31345,85,32,95,5,14,187,0.037,0500000US42047,Elk County,30990,294,30696,29727,29466,74,16,113,12,46,969,0.095,0.058,1.550,5.8%,155.0%
0500000US42049,42049,42,49,"Erie County, Pennsylvania",280566,9518,271048,266119,242787,19485,447,3036,72,292,4929,0.245,0500000US42049,Erie County,270876,12030,258846,246806,219180,19821,343,6358,58,1046,12040,0.335,0.091,0.370,9.1%,37.0%
0500000US42051,42051,42,51,"Fayette County, Pennsylvania",136606,1049,135557,133834,126888,6270,161,397,23,95,1723,0.135,0500000US42051,Fayette County,128804,1578,127226,122040,115322,5703,166,376,160,313,5186,0.195,0.060,0.443,6.0%,44.3%
0500000US42053,42053,42,53,"Forest County, Pennsylvania",7716,418,7298,7253,5850,1374,11,12,1,5,45,0.391,0500000US42053,Forest County,6973,323,6650,6542,5278,1235,8,17,0,4,108,0.393,0.003,0.007,0.3%,0.7%
0500000US42055,42055,42,55,"Franklin County, Pennsylvania",149618,6438,143180,141035,135004,4348,230,1294,17,142,2145,0.183,0500000US42055,Franklin County,155932,10764,145168,139755,132566,4998,242,1408,40,501,5413,0.270,0.087,0.478,8.7%,47.8%
0500000US42057,42057,42,57,"Fulton County, Pennsylvania",14845,123,14722,14581,14387,144,26,19,1,4,141,0.060,0500000US42057,Fulton County,14556,146,14410,13936,13726,124,25,41,3,17,474,0.110,0.049,0.811,4.9%,81.1%
0500000US42059,42059,42,59,"Greene County, Pennsylvania",38686,465,38221,37869,36409,1272,59,113,6,10,352,0.113,0500000US42059,Greene County,35954,510,35444,34218,32898,1062,69,120,6,63,1226,0.161,0.048,0.421,4.8%,42.1%
0500000US42061,42061,42,61,"Huntingdon County, Pennsylvania",45913,727,45186,44805,42197,2369,36,181,0,22,381,0.152,0500000US42061,Huntingdon County,44092,852,43240,42055,39420,2267,49,210,9,100,1185,0.197,0.045,0.293,4.5%,29.3%
0500000US42063,42063,42,63,"Indiana County, Pennsylvania",88880,947,87933,87169,83864,2374,103,768,9,51,764,0.109,0500000US42063,Indiana County,83246,1476,81770,79214,75718,2409,116,816,7,148,2556,0.170,0.062,0.568,6.2%,56.8%
0500000US42065,42065,42,65,"Jefferson County, Pennsylvania",45200,275,44925,44585,44264,147,72,91,3,8,340,0.041,0500000US42065,Jefferson County,44492,397,44095,42687,42317,125,45,100,8,92,1408,0.094,0.053,1.307,5.3%,130.7%
0500000US42067,42067,42,67,"Juniata County, Pennsylvania",24636,623,24013,23834,23584,134,24,85,1,6,179,0.083,0500000US42067,Juniata County,23509,908,22601,22085,21830,115,19,69,4,48,516,0.136,0.053,0.638,5.3%,63.8%
0500000US42069,42069,42,69,"Lackawanna County, Pennsylvania",214437,10682,203755,201221,192250,4794,220,3601,41,315,2534,0.193,0500000US42069,Lackawanna County,215896,18267,197629,190555,175246,7415,276,6762,28,828,7074,0.331,0.138,0.715,13.8%,71.5%
0500000US42071,42071,42,71,"Lancaster County, Pennsylvania",519445,44930,474515,467996,440969,16087,658,9726,108,448,6519,0.270,0500000US42071,Lancaster County,552984,61171,491813,476642,440613,19536,522,13939,110,1922,15171,0.350,0.080,0.295,8.0%,29.5%
0500000US42073,42073,42,73,"Lawrence County, Pennsylvania",91108,931,90177,88817,84872,3448,54,365,9,69,1360,0.130,0500000US42073,Lawrence County,86070,1655,84415,80008,75811,3546,75,321,4,251,4407,0.219,0.089,0.683,8.9%,68.3%
0500000US42075,42075,42,75,"Lebanon County, Pennsylvania",133568,12410,121158,119922,116010,2134,133,1504,30,111,1236,0.237,0500000US42075,Lebanon County,143257,20348,122909,119369,114004,2555,119,2192,39,460,3540,0.345,0.109,0.460,10.9%,46.0%
0500000US42077,42077,42,77,"Lehigh County, Pennsylvania",349497,65615,283882,278627,250245,17230,442,10090,65,555,5255,0.449,0500000US42077,Lehigh County,374557,96981,277576,266876,227994,22950,337,13725,91,1779,10700,0.557,0.108,0.241,10.8%,24.1%
0500000US42079,42079,42,79,"Luzerne County, Pennsylvania",320918,21491,299427,296231,283058,9539,280,3079,41,234,3196,0.216,0500000US42079,Luzerne County,325594,46898,278696,269640,250304,14031,295,3960,65,985,9056,0.385,0.169,0.781,16.9%,78.1%
0500000US42081,42081,42,81,"Lycoming County, Pennsylvania",116111,1559,114552,112751,106710,5060,191,663,24,103,1801,0.153,0500000US42081,Lycoming County,114188,2374,111814,106883,99687,5672,191,923,27,383,4931,0.233,0.080,0.523,8.0%,52.3%
0500000US42083,42083,42,83,"McKean County, Pennsylvania",43450,757,42693,42337,41039,1008,83,191,3,13,356,0.107,0500000US42083,McKean County,40432,642,39790,38219,36991,849,102,193,2,82,1571,0.161,0.054,0.503,5.4%,50.3%
0500000US42085,42085,42,85,"Mercer County, Pennsylvania",116638,1248,115390,113772,106176,6620,132,726,15,103,1618,0.168,0500000US42085,Mercer County,110652,1609,109043,104442,96998,6289,116,683,14,342,4601,0.226,0.059,0.349,5.9%,34.9%
0500000US42087,42087,42,87,"Mifflin County, Pennsylvania",46682,534,46148,45732,45199,282,52,167,6,26,416,0.062,0500000US42087,Mifflin County,46143,979,45164,43982,43343,350,51,160,0,78,1182,0.116,0.054,0.871,5.4%,87.1%
0500000US42089,42089,42,89,"Monroe County, Pennsylvania",169842,22288,147554,144518,119741,20461,358,3395,60,503,3036,0.470,0500000US42089,Monroe County,168327,28558,139769,133238,104716,22823,289,3947,56,1407,6531,0.564,0.093,0.198,9.3%,19.8%
0500000US42091,42091,42,91,"Montgomery County, Pennsylvania",799874,34233,765641,752938,631784,67582,791,51354,221,1206,12703,0.363,0500000US42091,Montgomery County,856553,54512,802041,770309,618244,79510,763,67761,168,3863,31732,0.459,0.096,0.264,9.6%,26.4%
0500000US42093,42093,42,93,"Montour County, Pennsylvania",18267,324,17943,17790,17206,237,12,323,2,10,153,0.112,0500000US42093,Montour County,18136,487,17649,17142,16105,320,27,668,0,22,507,0.208,0.096,0.861,9.6%,86.1%
0500000US42095,42095,42,95,"Northampton County, Pennsylvania",297735,31179,266556,262326,241163,13207,329,7131,74,422,4230,0.330,0500000US42095,Northampton County,312951,44597,268354,257667,228373,17429,251,9892,75,1647,10687,0.442,0.112,0.338,11.2%,33.8%
0500000US42097,42097,42,97,"Northumberland County, Pennsylvania",94528,2253,92275,91504,89166,1814,115,325,10,74,771,0.109,0500000US42097,Northumberland County,91647,4151,87496,84858,81689,2392,110,444,24,199,2638,0.202,0.093,0.849,9.3%,84.9%
0500000US42099,42099,42,99,"Perry County, Pennsylvania",45969,588,45381,44971,44427,284,58,163,14,25,410,0.066,0500000US42099,Perry County,45842,912,44930,43458,42838,289,50,139,3,139,1472,0.125,0.060,0.908,6.0%,90.8%
0500000US42101,42101,42,101,"Philadelphia County, Pennsylvania",1526006,187611,1338395,1310453,562585,644287,3498,95521,457,4105,27942,0.666,0500000US42101,Philadelphia County,1603797,238277,1365520,1311665,550828,613835,2596,132408,579,11419,53855,0.705,0.039,0.059,3.9%,5.9%
0500000US42103,42103,42,103,"Pike County, Pennsylvania",57369,5173,52196,51399,47549,3050,127,583,13,77,797,0.302,0500000US42103,Pike County,58535,6719,51816,49612,45375,3027,121,841,14,234,2204,0.382,0.080,0.264,8.0%,26.4%
0500000US42105,42105,42,105,"Potter County, Pennsylvania",17457,181,17276,17140,17000,61,32,45,1,1,136,0.051,0500000US42105,Potter County,16396,247,16149,15683,15494,43,25,69,0,52,466,0.106,0.054,1.058,5.4%,105.8%
0500000US42107,42107,42,107,"Schuylkill County, Pennsylvania",148289,4080,144209,143038,138248,3841,162,703,24,60,1171,0.129,0500000US42107,Schuylkill County,143049,8064,134985,131510,126192,4115,155,748,13,287,3475,0.217,0.088,0.679,8.8%,67.9%
0500000US42109,42109,42,109,"Snyder County, Pennsylvania",39702,657,39045,38773,38127,375,43,211,5,12,272,0.077,0500000US42109,Snyder County,39736,977,38759,37893,36992,504,32,296,11,58,866,0.132,0.055,0.708,5.5%,70.8%
0500000US42111,42111,42,111,"Somerset County, Pennsylvania",77742,840,76902,76462,74265,1856,76,238,16,11,440,0.087,0500000US42111,Somerset County,74129,1037,73092,71284,69044,1863,50,194,7,126,1808,0.131,0.044,0.511,4.4%,51.1%
0500000US42113,42113,42,113,"Sullivan County, Pennsylvania",6428,92,6336,6297,6089,163,26,19,0,0,39,0.102,0500000US42113,Sullivan County,5840,105,5735,5538,5406,77,9,17,0,29,197,0.141,0.040,0.390,4.0%,39.0%
0500000US42115,42115,42,115,"Susquehanna County, Pennsylvania",43356,564,42792,42467,42117,150,52,121,9,18,325,0.056,0500000US42115,Susquehanna County,38434,847,37587,36229,35799,138,59,135,0,98,1358,0.131,0.075,1.329,7.5%,132.9%
0500000US42117,42117,42,117,"Tioga County, Pennsylvania",41981,437,41544,41158,40560,322,81,181,4,10,386,0.066,0500000US42117,Tioga County,41045,640,40405,38946,38257,321,73,189,7,99,1459,0.130,0.063,0.956,6.3%,95.6%
0500000US42119,42119,42,119,"Union County, Pennsylvania",44947,2346,42601,42076,38311,3048,125,520,21,51,525,0.266,0500000US42119,Union County,42681,2000,40681,39525,36050,2459,82,814,8,112,1156,0.280,0.014,0.053,1.4%,5.3%
0500000US42121,42121,42,121,"Venango County, Pennsylvania",54984,478,54506,53924,53052,567,81,196,10,18,582,0.069,0500000US42121,Venango County,50454,577,49877,47897,47117,434,68,172,10,96,1980,0.126,0.057,0.835,5.7%,83.5%
0500000US42123,42123,42,123,"Warren County, Pennsylvania",41815,305,41510,41206,40827,136,71,156,12,4,304,0.047,0500000US42123,Warren County,38587,415,38172,36741,36310,144,71,154,5,57,1431,0.113,0.066,1.427,6.6%,142.7%
0500000US42125,42125,42,125,"Washington County, Pennsylvania",207820,2366,205454,202554,194171,6650,214,1313,28,178,2900,0.126,0500000US42125,Washington County,209349,4021,205328,196672,186900,6861,230,1998,63,620,8656,0.200,0.074,0.589,7.4%,58.9%
0500000US42127,42127,42,127,"Wayne County, Pennsylvania",52822,1816,51006,50525,48590,1563,85,252,3,32,481,0.152,0500000US42127,Wayne County,51155,2347,48808,47124,44821,1647,73,418,0,165,1684,0.228,0.076,0.503,7.6%,50.3%
0500000US42129,42129,42,129,"Westmoreland County, Pennsylvania",365169,3179,361990,357834,346111,8425,305,2692,59,242,4156,0.101,0500000US42129,Westmoreland County,354663,5230,349433,336684,323114,8985,295,3301,36,953,12749,0.168,0.067,0.663,6.7%,66.3%
0500000US42131,42131,42,131,"Wyoming County, Pennsylvania",28276,437,27839,27610,27270,185,51,94,3,7,229,0.070,0500000US42131,Wyoming County,26069,581,25488,24546,24142,214,32,115,3,40,942,0.140,0.071,1.020,7.1%,102.0%
0500000US42133,42133,42,133,"York County, Pennsylvania",434972,24397,410575,403960,374779,22493,635,5336,108,609,6615,0.251,0500000US42133,York County,456438,39360,417078,400204,365353,25768,640,6557,118,1768,16874,0.347,0.096,0.381,9.6%,38.1%
0500000US44001,44001,44,1,"Bristol County, Rhode Island",49875,989,48886,48244,47052,363,71,704,3,51,642,0.109,0500000US44001,Bristol County,50793,1943,48850,46937,44671,732,85,1279,1,169,1913,0.223,0.114,1.041,11.4%,104.1%
0500000US44003,44003,44,3,"Kent County, Rhode Island",166158,5309,160849,158305,152141,2157,355,3346,29,277,2544,0.160,0500000US44003,Kent County,170363,9665,160698,153643,144761,2889,364,4830,32,767,7055,0.272,0.112,0.702,11.2%,70.2%
0500000US44005,44005,44,5,"Newport County, Rhode Island",82888,3512,79376,77323,72836,2645,260,1263,45,274,2053,0.224,0500000US44005,Newport County,85643,5592,80051,76015,70914,2645,265,1543,49,599,4036,0.307,0.082,0.368,8.2%,36.8%
0500000US44007,44007,44,7,"Providence County, Rhode Island",626667,117819,508848,492611,414326,45048,2327,22621,205,8084,16237,0.520,0500000US44007,Providence County,660741,160323,500418,465816,378615,47652,1882,28110,190,9367,34602,0.603,0.083,0.159,8.3%,15.9%
0500000US44009,44009,44,9,"Washington County, Rhode Island",126979,3026,123953,121950,117330,1347,1007,2054,23,189,2003,0.145,0500000US44009,Washington County,129839,4578,125261,120617,115089,1468,917,2605,48,490,4644,0.211,0.066,0.457,6.6%,45.7%
0500000US45001,45001,45,1,"Abbeville County, South Carolina",25417,255,25162,24886,17564,7160,59,75,5,23,276,0.443,0500000US45001,Abbeville County,24295,423,23872,23120,16744,6184,44,71,7,70,752,0.459,0.016,0.036,1.6%,3.6%
0500000US45003,45003,45,3,"Aiken County, South Carolina",160099,7824,152275,149767,108566,39043,589,1318,52,199,2508,0.478,0500000US45003,Aiken County,168808,11526,157282,150451,107918,39465,530,1773,96,669,6831,0.530,0.052,0.109,5.2%,10.9%
0500000US45005,45005,45,5,"Allendale County, South Carolina",10419,239,10180,10122,2410,7645,19,41,2,5,58,0.408,0500000US45005,Allendale County,8039,194,7845,7707,1985,5646,45,17,1,13,138,0.445,0.037,0.092,3.7%,9.2%
0500000US45007,45007,45,7,"Anderson County, South Carolina",187126,5447,181679,179188,147362,29810,420,1384,29,183,2491,0.353,0500000US45007,Anderson County,203718,9574,194144,186183,152396,30214,425,2404,46,698,7961,0.414,0.061,0.173,6.1%,17.3%
0500000US45009,45009,45,9,"Bamberg County, South Carolina",15987,258,15729,15592,5691,9786,38,68,3,6,137,0.498,0500000US45009,Bamberg County,13311,141,13170,12886,5010,7749,25,66,0,36,284,0.519,0.021,0.041,2.1%,4.1%
0500000US45011,45011,45,11,"Barnwell County, South Carolina",22621,411,22210,21910,11715,9964,84,126,2,19,300,0.537,0500000US45011,Barnwell County,20589,520,20069,19431,10352,8785,61,161,14,58,638,0.563,0.026,0.049,2.6%,4.9%
0500000US45013,45013,45,13,"Beaufort County, South Carolina",162233,19567,142666,140396,107279,30662,338,1822,78,217,2270,0.512,0500000US45013,Beaufort County,187117,23411,163706,157778,126704,27545,354,2381,119,675,5928,0.503,-0.009,-0.018,-0.9%,-1.8%
0500000US45015,45015,45,15,"Berkeley County, South Carolina",177843,10755,167088,163149,113553,44023,910,3981,146,536,3939,0.526,0500000US45015,Berkeley County,229861,20328,209533,197905,137840,51784,1035,5353,173,1720,11628,0.579,0.052,0.099,5.2%,9.9%
0500000US45017,45017,45,17,"Calhoun County, South Carolina",15175,458,14717,14570,8059,6420,43,31,9,8,147,0.538,0500000US45017,Calhoun County,14119,487,13632,13269,7783,5361,62,27,6,30,363,0.550,0.012,0.023,1.2%,2.3%
0500000US45019,45019,45,19,"Charleston County, South Carolina",350209,18877,331332,326954,217260,103479,838,4660,246,471,4378,0.525,0500000US45019,Charleston County,408235,29280,378955,365476,263560,91746,857,7461,319,1533,13479,0.526,0.002,0.003,0.2%,0.3%
0500000US45021,45021,45,21,"Cherokee County, South Carolina",55342,2032,53310,52645,40939,11214,129,308,6,49,665,0.410,0500000US45021,Cherokee County,56216,2777,53439,51579,39576,11292,161,341,14,195,1860,0.460,0.050,0.123,5.0%,12.3%
0500000US45023,45023,45,23,"Chester County, South Carolina",33140,479,32661,32218,19590,12349,130,104,5,40,443,0.511,0500000US45023,Chester County,32294,795,31499,30316,18591,11287,145,146,14,133,1183,0.544,0.033,0.065,3.3%,6.5%
0500000US45025,45025,45,25,"Chesterfield County, South Carolina",46734,1666,45068,44422,28790,15179,223,171,9,50,646,0.514,0500000US45025,Chesterfield County,43273,2086,41187,39554,25829,13150,184,269,4,118,1633,0.548,0.034,0.066,3.4%,6.6%
0500000US45027,45027,45,27,"Clarendon County, South Carolina",34971,899,34072,33843,16160,17379,71,222,4,7,229,0.539,0500000US45027,Clarendon County,31144,907,30237,29556,15309,13821,120,225,8,73,681,0.560,0.021,0.040,2.1%,4.0%
0500000US45029,45029,45,29,"Colleton County, South Carolina",38892,1094,37798,37309,21736,15109,308,125,7,24,489,0.536,0500000US45029,Colleton County,38604,1380,37224,35822,21816,13401,302,186,16,101,1402,0.557,0.022,0.041,2.2%,4.1%
0500000US45031,45031,45,31,"Darlington County, South Carolina",68681,1140,67541,66885,37993,28463,184,201,6,38,656,0.522,0500000US45031,Darlington County,62905,1396,61509,59765,33821,25386,136,290,4,128,1744,0.547,0.025,0.048,2.5%,4.8%
0500000US45033,45033,45,33,"Dillon County, South Carolina",32062,833,31229,30751,15152,14730,751,76,8,34,478,0.564,0500000US45033,Dillon County,28292,856,27436,26438,12987,12709,603,63,1,75,998,0.585,0.021,0.037,2.1%,3.7%
0500000US45035,45035,45,35,"Dorchester County, South Carolina",136555,6075,130480,127460,89427,34861,853,2016,127,176,3020,0.503,0500000US45035,Dorchester County,161540,10861,150679,142587,99145,38278,886,3286,199,793,8092,0.560,0.056,0.112,5.6%,11.2%
0500000US45037,45037,45,37,"Edgefield County, South Carolina",26985,1414,25571,25334,15196,9951,62,94,11,20,237,0.544,0500000US45037,Edgefield County,25657,1371,24286,23475,14890,8301,67,118,6,93,811,0.555,0.011,0.019,1.1%,1.9%
0500000US45039,45039,45,39,"Fairfield County, South Carolina",23956,374,23582,23341,9098,14112,47,54,0,30,241,0.508,0500000US45039,Fairfield County,20948,423,20525,19931,8503,11201,64,101,7,55,594,0.548,0.040,0.078,4.0%,7.8%
0500000US45041,45041,45,41,"Florence County, South Carolina",136885,3030,133855,132537,74105,56204,424,1660,23,121,1318,0.538,0500000US45041,Florence County,137059,4283,132776,128949,69021,56877,330,2309,48,364,3827,0.572,0.035,0.064,3.5%,6.4%
0500000US45043,45043,45,43,"Georgetown County, South Carolina",60158,1867,58291,57873,37311,20128,128,269,6,31,418,0.502,0500000US45043,Georgetown County,63404,2225,61179,59763,41186,18051,111,258,27,130,1416,0.495,-0.007,-0.014,-0.7%,-1.4%
0500000US45045,45045,45,45,"Greenville County, South Carolina",451225,36495,414730,408387,317197,80569,915,8772,217,717,6343,0.467,0500000US45045,Greenville County,525534,58025,467509,447532,343897,87124,893,12875,398,2345,19977,0.530,0.063,0.135,6.3%,13.5%
0500000US45047,45047,45,47,"Greenwood County, South Carolina",69661,3789,65872,65241,42709,21728,139,568,11,86,631,0.524,0500000US45047,Greenwood County,69351,4749,64602,62451,40625,20820,102,678,41,185,2151,0.561,0.037,0.071,3.7%,7.1%
0500000US45049,45049,45,49,"Hampton County, South Carolina",21090,744,20346,20135,8699,11264,45,106,7,14,211,0.543,0500000US45049,Hampton County,18561,666,17895,17536,7802,9536,41,100,17,40,359,0.558,0.014,0.027,1.4%,2.7%
0500000US45051,45051,45,51,"Horry County, South Carolina",269291,16683,252608,248325,208096,35753,1075,2774,232,395,4283,0.381,0500000US45051,Horry County,351029,24304,326725,312573,265729,39367,1174,4578,303,1422,14152,0.408,0.027,0.070,2.7%,7.0%
0500000US45053,45053,45,53,"Jasper County, South Carolina",24777,3752,21025,20810,9263,11303,49,169,5,21,215,0.629,0500000US45053,Jasper County,28791,5079,23712,22992,13056,9559,59,187,23,108,720,0.652,0.023,0.037,2.3%,3.7%
0500000US45055,45055,45,55,"Kershaw County, South Carolina",61697,2298,59399,58625,43009,15057,182,296,26,55,774,0.453,0500000US45055,Kershaw County,65403,3466,61937,59305,43391,15083,146,417,29,239,2632,0.502,0.049,0.109,4.9%,10.9%
0500000US45057,45057,45,57,"Lancaster County, South Carolina",76652,3384,73268,72493,53490,18162,214,492,15,120,775,0.455,0500000US45057,Lancaster County,96016,6294,89722,86364,64927,19101,220,1765,14,337,3358,0.497,0.042,0.093,4.2%,9.3%
0500000US45059,45059,45,59,"Laurens County, South Carolina",66537,2729,63808,63095,45900,16808,137,175,25,50,713,0.458,0500000US45059,Laurens County,67539,4147,63392,60996,44358,15937,144,295,24,238,2396,0.508,0.049,0.108,4.9%,10.8%
0500000US45061,45061,45,61,"Lee County, South Carolina",19220,334,18886,18753,6322,12315,49,58,3,6,133,0.481,0500000US45061,Lee County,16531,295,16236,15873,5721,10054,49,34,0,15,363,0.510,0.029,0.060,2.9%,6.0%
0500000US45063,45063,45,63,"Lexington County, South Carolina",262391,14529,247862,244026,201946,36995,957,3693,105,330,3836,0.384,0500000US45063,Lexington County,293991,21797,272194,260048,208854,42382,894,6644,185,1089,12146,0.467,0.083,0.215,8.3%,21.5%
0500000US45065,45065,45,65,"McCormick County, South Carolina",10233,81,10152,10068,4941,5069,9,34,3,12,84,0.521,0500000US45065,McCormick County,9526,123,9403,9168,5155,3916,27,36,2,32,235,0.537,0.016,0.031,1.6%,3.1%
0500000US45067,45067,45,67,"Marion County, South Carolina",33062,791,32271,31922,13230,18365,133,176,2,16,349,0.531,0500000US45067,Marion County,29183,710,28473,27692,11080,16333,109,128,0,42,781,0.541,0.011,0.020,1.1%,2.0%
0500000US45069,45069,45,69,"Marlboro County, South Carolina",28933,800,28133,27674,11657,14652,1265,74,3,23,459,0.578,0500000US45069,Marlboro County,26667,575,26092,25133,10556,13302,1130,99,7,39,959,0.591,0.013,0.022,1.3%,2.2%
0500000US45071,45071,45,71,"Newberry County, South Carolina",37508,2690,34818,34484,22690,11533,99,116,10,36,334,0.534,0500000US45071,Newberry County,37719,3305,34414,33313,22635,10360,107,135,4,72,1101,0.556,0.022,0.040,2.2%,4.0%
0500000US45073,45073,45,73,"Oconee County, South Carolina",74273,3349,70924,69979,63807,5550,152,421,8,41,945,0.254,0500000US45073,Oconee County,78607,4384,74223,70780,64696,5119,176,591,16,182,3443,0.313,0.059,0.233,5.9%,23.3%
0500000US45075,45075,45,75,"Orangeburg County, South Carolina",92501,1767,90734,89780,31206,57286,468,751,12,57,954,0.502,0500000US45075,Orangeburg County,84223,1967,82256,80185,27787,50802,467,892,37,200,2071,0.526,0.024,0.048,2.4%,4.8%
0500000US45077,45077,45,77,"Pickens County, South Carolina",119224,3743,115481,113992,103958,7792,210,1900,14,118,1489,0.234,0500000US45077,Pickens County,131404,6572,124832,119158,107247,8421,304,2723,37,426,5674,0.325,0.091,0.389,9.1%,38.9%
0500000US45079,45079,45,79,"Richland County, South Carolina",384504,18637,365867,359170,174267,174549,987,8433,372,562,6697,0.585,0500000US45079,Richland County,416147,26095,390052,375302,172644,188141,888,11330,427,1872,14750,0.618,0.032,0.055,3.2%,5.5%
0500000US45081,45081,45,81,"Saluda County, South Carolina",19875,2857,17018,16844,11548,5196,43,36,11,10,174,0.573,0500000US45081,Saluda County,18862,3012,15850,15409,11264,4028,44,35,0,38,441,0.572,-0.002,-0.003,-0.2%,-0.3%
0500000US45083,45083,45,83,"Spartanburg County, South Carolina",284307,16658,267649,263931,199184,58115,562,5680,69,321,3718,0.463,0500000US45083,Spartanburg County,327997,27732,300265,288172,214440,63565,699,8176,190,1102,12093,0.526,0.062,0.135,6.2%,13.5%
0500000US45085,45085,45,85,"Sumter County, South Carolina",107456,3532,103924,102257,50423,50110,334,1167,93,130,1667,0.561,0500000US45085,Sumter County,105556,4302,101254,97119,46442,48536,338,1400,87,316,4135,0.592,0.031,0.055,3.1%,5.5%
0500000US45087,45087,45,87,"Union County, South Carolina",28961,282,28679,28344,19146,9022,63,79,11,23,335,0.466,0500000US45087,Union County,27244,438,26806,25900,17279,8435,56,78,3,49,906,0.501,0.035,0.075,3.5%,7.5%
0500000US45089,45089,45,89,"Williamsburg County, South Carolina",34423,689,33734,33522,10725,22526,102,137,3,29,212,0.474,0500000US45089,Williamsburg County,31026,619,30407,29859,9986,19579,85,147,1,61,548,0.497,0.023,0.049,2.3%,4.9%
0500000US45091,45091,45,91,"York County, South Carolina",226073,10075,215998,212477,164371,42608,1777,3394,72,255,3521,0.433,0500000US45091,York County,282090,18938,263152,251206,188015,51298,1892,8745,111,1145,11946,0.515,0.082,0.189,8.2%,18.9%
0500000US46003,46003,46,3,"Aurora County, South Dakota",2710,101,2609,2596,2531,9,38,18,0,0,13,0.126,0500000US46003,Aurora County,2747,219,2528,2474,2409,14,38,13,0,0,54,0.224,0.098,0.776,9.8%,77.6%
0500000US46005,46005,46,5,"Beadle County, South Dakota",17398,1337,16061,15862,14934,118,165,632,8,5,199,0.256,0500000US46005,Beadle County,19149,2741,16408,15907,13369,142,243,2068,57,28,501,0.480,0.224,0.875,22.4%,87.5%
0500000US46007,46007,46,7,"Bennett County, South Dakota",3431,67,3364,3234,1141,3,2072,13,3,2,130,0.523,0500000US46007,Bennett County,3381,87,3294,3073,997,7,2060,7,0,2,221,0.537,0.014,0.027,1.4%,2.7%
0500000US46009,46009,46,9,"Bon Homme County, South Dakota",7070,130,6940,6857,6285,65,494,10,0,3,83,0.204,0500000US46009,Bon Homme County,7003,117,6886,6743,6160,106,455,11,5,6,143,0.221,0.017,0.082,1.7%,8.2%
0500000US46011,46011,46,11,"Brookings County, South Dakota",31965,636,31329,30928,29513,246,272,866,9,22,401,0.146,0500000US46011,Brookings County,34375,1427,32948,31911,29922,628,372,912,13,64,1037,0.239,0.092,0.632,9.2%,63.2%
0500000US46013,46013,46,13,"Brown County, South Dakota",36531,496,36035,35502,33825,187,1078,353,42,17,533,0.141,0500000US46013,Brown County,38301,1659,36642,35401,32705,535,1103,918,44,96,1241,0.266,0.125,0.885,12.5%,88.5%
0500000US46015,46015,46,15,"Brule County, South Dakota",5255,75,5180,5062,4615,12,425,9,1,0,118,0.221,0500000US46015,Brule County,5247,106,5141,4900,4340,28,495,26,5,6,241,0.304,0.083,0.374,8.3%,37.4%
0500000US46017,46017,46,17,"Buffalo County, South Dakota",1912,35,1877,1863,283,4,1575,1,0,0,14,0.299,0500000US46017,Buffalo County,1948,13,1935,1869,286,0,1582,1,0,0,66,0.318,0.019,0.062,1.9%,6.2%
0500000US46019,46019,46,19,"Butte County, South Dakota",10110,306,9804,9579,9360,20,170,21,7,1,225,0.141,0500000US46019,Butte County,10243,410,9833,9406,9147,12,182,30,5,30,427,0.199,0.058,0.409,5.8%,40.9%
0500000US46021,46021,46,21,"Campbell County, South Dakota",1466,20,1446,1440,1430,1,5,4,0,0,6,0.048,0500000US46021,Campbell County,1377,37,1340,1307,1270,0,31,6,0,0,33,0.148,0.099,2.056,9.9%,205.6%
0500000US46023,46023,46,23,"Charles Mix County, South Dakota",9129,152,8977,8755,5899,8,2830,18,0,0,222,0.485,0500000US46023,Charles Mix County,9373,228,9145,8794,5720,15,3011,31,14,3,351,0.522,0.037,0.076,3.7%,7.6%
0500000US46025,46025,46,25,"Clark County, South Dakota",3691,63,3628,3606,3596,6,2,2,0,0,22,0.050,0500000US46025,Clark County,3837,169,3668,3609,3573,12,20,2,2,0,59,0.131,0.080,1.588,8.0%,158.8%
0500000US46027,46027,46,27,"Clay County, South Dakota",13864,277,13587,13321,12484,179,408,230,3,17,266,0.187,0500000US46027,Clay County,14967,458,14509,13845,12655,235,552,361,4,38,664,0.280,0.093,0.497,9.3%,49.7%
0500000US46029,46029,46,29,"Codington County, South Dakota",27227,433,26794,26485,25762,88,512,121,0,2,309,0.104,0500000US46029,Codington County,28325,739,27586,26843,25841,109,645,197,3,48,743,0.166,0.062,0.594,6.2%,59.4%
0500000US46031,46031,46,31,"Corson County, South Dakota",4050,106,3944,3853,1202,3,2635,11,1,1,91,0.487,0500000US46031,Corson County,3902,46,3856,3685,957,6,2702,20,0,0,171,0.458,-0.029,-0.060,-2.9%,-6.0%
0500000US46033,46033,46,33,"Custer County, South Dakota",8216,182,8034,7897,7624,15,228,27,2,1,137,0.137,0500000US46033,Custer County,8318,211,8107,7766,7506,32,161,25,0,42,341,0.183,0.046,0.332,4.6%,33.2%
0500000US46035,46035,46,35,"Davison County, South Dakota",19504,294,19210,18948,18296,71,472,91,10,8,262,0.119,0500000US46035,Davison County,19956,913,19043,18500,17625,127,602,117,0,29,543,0.216,0.097,0.816,9.7%,81.6%
0500000US46037,46037,46,37,"Day County, South Dakota",5710,62,5648,5560,5004,8,535,12,0,1,88,0.223,0500000US46037,Day County,5449,153,5296,5158,4595,3,536,19,4,1,138,0.278,0.055,0.246,5.5%,24.6%
0500000US46039,46039,46,39,"Deuel County, South Dakota",4364,86,4278,4250,4220,12,12,4,0,2,28,0.064,0500000US46039,Deuel County,4295,137,4158,4089,4045,10,26,2,5,1,69,0.112,0.047,0.733,4.7%,73.3%
0500000US46041,46041,46,41,"Dewey County, South Dakota",5301,98,5203,5034,1108,5,3914,7,0,0,169,0.410,0500000US46041,Dewey County,5239,81,5158,4950,849,9,4082,6,0,4,208,0.365,-0.045,-0.110,-4.5%,-11.0%
0500000US46043,46043,46,43,"Douglas County, South Dakota",3002,23,2979,2959,2891,11,54,3,0,0,20,0.072,0500000US46043,Douglas County,2835,54,2781,2698,2653,7,33,3,1,1,83,0.123,0.051,0.704,5.1%,70.4%
0500000US46045,46045,46,45,"Edmunds County, South Dakota",4071,58,4013,3976,3949,5,17,5,0,0,37,0.059,0500000US46045,Edmunds County,3986,61,3925,3853,3779,12,39,23,0,0,72,0.100,0.042,0.711,4.2%,71.1%
0500000US46047,46047,46,47,"Fall River County, South Dakota",7094,159,6935,6750,6199,46,474,26,3,2,185,0.231,0500000US46047,Fall River County,6973,180,6793,6445,5932,35,391,47,11,29,348,0.270,0.039,0.170,3.9%,17.0%
0500000US46049,46049,46,49,"Faulk County, South Dakota",2364,18,2346,2331,2323,3,3,2,0,0,15,0.034,0500000US46049,Faulk County,2125,46,2079,2054,2003,2,45,3,0,1,25,0.110,0.076,2.222,7.6%,222.2%
0500000US46051,46051,46,51,"Grant County, South Dakota",7356,168,7188,7139,7072,10,36,21,0,0,49,0.075,0500000US46051,Grant County,7556,480,7076,6904,6806,0,71,16,3,8,172,0.184,0.109,1.449,10.9%,144.9%
0500000US46053,46053,46,53,"Gregory County, South Dakota",4271,38,4233,4148,3818,6,312,11,0,1,85,0.195,0500000US46053,Gregory County,3994,52,3942,3791,3491,9,264,21,4,2,151,0.230,0.035,0.179,3.5%,17.9%
0500000US46055,46055,46,55,"Haakon County, South Dakota",1937,17,1920,1871,1823,2,37,8,1,0,49,0.113,0500000US46055,Haakon County,1872,19,1853,1783,1717,2,34,14,2,14,70,0.157,0.044,0.386,4.4%,38.6%
0500000US46057,46057,46,57,"Hamlin County, South Dakota",5903,149,5754,5721,5679,10,19,13,0,0,33,0.074,0500000US46057,Hamlin County,6164,288,5876,5742,5666,5,41,13,6,11,134,0.152,0.079,1.065,7.9%,106.5%
0500000US46059,46059,46,59,"Hand County, South Dakota",3431,19,3412,3392,3368,3,8,9,0,4,20,0.036,0500000US46059,Hand County,3145,49,3096,3031,2992,7,11,7,0,14,65,0.094,0.058,1.595,5.8%,159.5%
0500000US46061,46061,46,61,"Hanson County, South Dakota",3331,15,3316,3301,3279,0,11,11,0,0,15,0.031,0500000US46061,Hanson County,3461,33,3428,3342,3316,5,6,0,0,15,86,0.081,0.050,1.630,5.0%,163.0%
0500000US46063,46063,46,63,"Harding County, South Dakota",1255,20,1235,1218,1197,1,18,1,0,1,17,0.090,0500000US46063,Harding County,1311,32,1279,1246,1205,5,29,0,0,7,33,0.153,0.064,0.711,6.4%,71.1%
0500000US46065,46065,46,65,"Hughes County, South Dakota",17022,306,16716,16385,14471,84,1728,89,0,13,331,0.266,0500000US46065,Hughes County,17765,490,17275,16419,14085,83,2068,128,4,51,856,0.355,0.088,0.332,8.8%,33.2%
0500000US46067,46067,46,67,"Hutchinson County, South Dakota",7343,120,7223,7173,7090,28,40,12,0,3,50,0.067,0500000US46067,Hutchinson County,7427,157,7270,7144,7009,9,88,21,0,17,126,0.109,0.041,0.611,4.1%,61.1%
0500000US46069,46069,46,69,"Hyde County, South Dakota",1420,15,1405,1381,1263,1,113,3,1,0,24,0.202,0500000US46069,Hyde County,1262,24,1238,1200,1088,4,99,5,1,3,38,0.249,0.047,0.233,4.7%,23.3%
0500000US46071,46071,46,71,"Jackson County, South Dakota",3031,38,2993,2852,1292,5,1547,1,1,6,141,0.555,0500000US46071,Jackson County,2806,61,2745,2579,1045,11,1509,7,3,4,166,0.568,0.013,0.023,1.3%,2.3%
0500000US46073,46073,46,73,"Jerauld County, South Dakota",2071,84,1987,1973,1960,1,5,4,3,0,14,0.103,0500000US46073,Jerauld County,1663,74,1589,1559,1545,0,11,3,0,0,30,0.135,0.032,0.311,3.2%,31.1%
0500000US46075,46075,46,75,"Jones County, South Dakota",1006,13,993,974,949,1,20,0,4,0,19,0.109,0500000US46075,Jones County,917,11,906,828,773,4,49,0,0,2,78,0.279,0.170,1.557,17.0%,155.7%
0500000US46077,46077,46,77,"Kingsbury County, South Dakota",5148,72,5076,5035,4987,7,24,14,0,3,41,0.061,0500000US46077,Kingsbury County,5187,119,5068,4976,4926,5,25,11,7,2,92,0.097,0.036,0.587,3.6%,58.7%
0500000US46079,46079,46,79,"Lake County, South Dakota",11200,175,11025,10916,10708,55,70,79,3,1,109,0.085,0500000US46079,Lake County,11059,606,10453,10153,9849,85,114,66,11,28,300,0.203,0.117,1.374,11.7%,137.4%
0500000US46081,46081,46,81,"Lawrence County, South Dakota",24097,612,23485,23066,22349,87,457,157,6,10,419,0.138,0500000US46081,Lawrence County,25768,922,24846,23814,22935,128,486,196,18,51,1032,0.204,0.066,0.477,6.6%,47.7%
0500000US46083,46083,46,83,"Lincoln County, South Dakota",44828,553,44275,43722,42700,315,217,462,7,21,553,0.092,0500000US46083,Lincoln County,65161,1679,63482,61213,58509,1116,432,993,9,154,2269,0.191,0.099,1.075,9.9%,107.5%
0500000US46085,46085,46,85,"Lyman County, South Dakota",3755,42,3713,3616,2181,3,1420,10,1,1,97,0.519,0500000US46085,Lyman County,3718,45,3673,3550,1915,3,1627,4,0,1,123,0.542,0.023,0.045,2.3%,4.5%
0500000US46087,46087,46,87,"McCook County, South Dakota",5618,99,5519,5490,5451,8,22,8,1,0,29,0.058,0500000US46087,McCook County,5682,175,5507,5351,5277,9,51,4,0,10,156,0.136,0.077,1.331,7.7%,133.1%
0500000US46089,46089,46,89,"McPherson County, South Dakota",2459,25,2434,2414,2405,1,1,4,3,0,20,0.043,0500000US46089,McPherson County,2411,53,2358,2299,2265,3,27,3,1,0,59,0.116,0.073,1.687,7.3%,168.7%
0500000US46091,46091,46,91,"Marshall County, South Dakota",4656,317,4339,4295,3938,5,343,9,0,0,44,0.274,0500000US46091,Marshall County,4306,255,4051,3942,3599,6,324,12,1,0,109,0.292,0.017,0.062,1.7%,6.2%
0500000US46093,46093,46,93,"Meade County, South Dakota",25434,773,24661,24018,22951,307,563,162,18,17,643,0.183,0500000US46093,Meade County,29852,1301,28551,26896,25294,408,784,275,48,87,1655,0.276,0.093,0.505,9.3%,50.5%
0500000US46095,46095,46,95,"Mellette County, South Dakota",2048,30,2018,1904,805,2,1092,5,0,0,114,0.558,0500000US46095,Mellette County,1918,39,1879,1763,651,1,1101,3,0,7,116,0.551,-0.007,-0.012,-0.7%,-1.2%
0500000US46097,46097,46,97,"Miner County, South Dakota",2389,31,2358,2338,2320,3,4,9,0,2,20,0.057,0500000US46097,Miner County,2298,42,2256,2206,2183,4,8,6,0,5,50,0.097,0.040,0.707,4.0%,70.7%
0500000US46099,46099,46,99,"Minnehaha County, South Dakota",169468,6982,162486,159172,146159,6326,3933,2489,76,189,3314,0.252,0500000US46099,Minnehaha County,197214,12034,185180,177151,155740,11411,4807,4568,71,554,8029,0.367,0.115,0.455,11.5%,45.5%
0500000US46101,46101,46,101,"Moody County, South Dakota",6486,111,6375,6219,5227,33,889,70,0,0,156,0.331,0500000US46101,Moody County,6336,314,6022,5698,4828,19,740,86,0,25,324,0.400,0.070,0.211,7.0%,21.1%
0500000US46113,46113,46,102,"Oglala Lakota County, South Dakota",13586,298,13288,13185,381,4,12784,14,2,0,103,0.113,0500000US46102,Oglala Lakota (Shannon) County,13672,402,13270,13036,438,24,12530,39,0,5,234,0.158,0.045,0.394,4.5%,39.4%
0500000US46103,46103,46,103,"Pennington County, South Dakota",100948,4044,96904,93681,82438,1013,9042,1041,76,71,3223,0.322,0500000US46103,Pennington County,109222,5575,103647,96985,82743,1363,10927,1463,78,411,6662,0.409,0.087,0.270,8.7%,27.0%
0500000US46105,46105,46,105,"Perkins County, South Dakota",2982,20,2962,2930,2883,2,35,4,0,6,32,0.065,0500000US46105,Perkins County,2835,38,2797,2733,2651,2,64,5,3,8,64,0.124,0.059,0.914,5.9%,91.4%
0500000US46107,46107,46,107,"Potter County, South Dakota",2329,17,2312,2291,2260,3,20,7,1,0,21,0.058,0500000US46107,Potter County,2472,39,2433,2392,2314,6,55,14,0,3,41,0.123,0.065,1.110,6.5%,111.0%
0500000US46109,46109,46,109,"Roberts County, South Dakota",10149,126,10023,9732,6238,11,3458,21,0,4,291,0.505,0500000US46109,Roberts County,10280,215,10065,9586,5577,32,3932,27,0,18,479,0.557,0.052,0.102,5.2%,10.2%
0500000US46111,46111,46,111,"Sanborn County, South Dakota",2355,28,2327,2306,2296,0,6,4,0,0,21,0.049,0500000US46111,Sanborn County,2330,57,2273,2211,2182,0,20,9,0,0,62,0.122,0.072,1.469,7.2%,146.9%
0500000US46115,46115,46,115,"Spink County, South Dakota",6415,71,6344,6298,6194,17,77,7,1,2,46,0.067,0500000US46115,Spink County,6361,143,6218,6082,5995,23,61,2,0,1,136,0.111,0.043,0.643,4.3%,64.3%
0500000US46117,46117,46,117,"Stanley County, South Dakota",2966,21,2945,2865,2656,9,196,4,0,0,80,0.193,0500000US46117,Stanley County,2980,31,2949,2777,2553,12,193,5,9,5,172,0.258,0.065,0.339,6.5%,33.9%
0500000US46119,46119,46,119,"Sully County, South Dakota",1373,12,1361,1340,1323,1,16,0,0,0,21,0.071,0500000US46119,Sully County,1446,42,1404,1355,1334,5,10,6,0,0,49,0.147,0.076,1.066,7.6%,106.6%
0500000US46121,46121,46,121,"Todd County, South Dakota",9612,227,9385,9245,913,16,8297,18,0,1,140,0.245,0500000US46121,Todd County,9319,222,9097,8862,685,10,8122,45,0,0,235,0.234,-0.011,-0.046,-1.1%,-4.6%
0500000US46123,46123,46,123,"Tripp County, South Dakota",5644,60,5584,5465,4676,6,769,12,0,2,119,0.294,0500000US46123,Tripp County,5624,54,5570,5303,4312,10,972,5,0,4,267,0.380,0.085,0.290,8.5%,29.0%
0500000US46125,46125,46,125,"Turner County, South Dakota",8347,112,8235,8172,8078,20,52,17,3,2,63,0.063,0500000US46125,Turner County,8673,249,8424,8161,8043,37,54,12,2,13,263,0.138,0.075,1.189,7.5%,118.9%
0500000US46127,46127,46,127,"Union County, South Dakota",14399,305,14094,13917,13608,89,76,127,11,6,177,0.106,0500000US46127,Union County,16811,661,16150,15586,14994,169,120,247,27,29,564,0.201,0.095,0.898,9.5%,89.8%
0500000US46129,46129,46,129,"Walworth County, South Dakota",5438,39,5399,5261,4472,6,769,13,0,1,138,0.303,0500000US46129,Walworth County,5315,99,5216,4930,4116,8,786,11,0,9,286,0.375,0.072,0.238,7.2%,23.8%
0500000US46135,46135,46,135,"Yankton County, South Dakota",22438,614,21824,21554,20563,327,537,115,5,7,270,0.158,0500000US46135,Yankton County,23310,1234,22076,21324,20195,312,638,129,9,41,752,0.245,0.086,0.544,8.6%,54.4%
0500000US46137,46137,46,137,"Ziebach County, South Dakota",2801,87,2714,2638,607,6,2023,2,0,0,76,0.430,0500000US46137,Ziebach County,2413,34,2379,2311,404,0,1899,3,3,2,68,0.352,-0.078,-0.182,-7.8%,-18.2%
0500000US47001,47001,47,1,"Anderson County, Tennessee",75129,1768,73361,72041,68134,2817,211,796,15,68,1320,0.175,0500000US47001,Anderson County,77123,2820,74303,70402,66044,2841,217,975,53,272,3901,0.261,0.086,0.491,8.6%,49.1%
0500000US47003,47003,47,3,"Bedford County, Tennessee",45058,5083,39975,39340,35389,3437,96,339,30,49,635,0.364,0500000US47003,Bedford County,50237,7665,42572,40679,36499,3563,127,337,13,140,1893,0.442,0.078,0.214,7.8%,21.4%
0500000US47005,47005,47,5,"Benton County, Tennessee",16489,291,16198,16025,15563,321,68,62,0,11,173,0.108,0500000US47005,Benton County,15864,375,15489,14885,14378,316,50,107,4,30,604,0.176,0.068,0.626,6.8%,62.6%
0500000US47007,47007,47,7,"Bledsoe County, Tennessee",12876,255,12621,12482,11936,469,52,17,3,5,139,0.139,0500000US47007,Bledsoe County,14913,459,14454,13997,13129,781,48,37,0,2,457,0.220,0.081,0.587,8.1%,58.7%
0500000US47009,47009,47,9,"Blount County, Tennessee",123010,3441,119569,117916,113240,3314,365,863,25,109,1653,0.151,0500000US47009,Blount County,135280,5709,129571,123585,117952,3552,339,1280,23,439,5986,0.235,0.084,0.560,8.4%,56.0%
0500000US47011,47011,47,11,"Bradley County, Tennessee",98963,4664,94299,92930,87589,4116,247,821,45,112,1369,0.212,0500000US47011,Bradley County,108620,8461,100159,94859,87830,5105,271,1188,117,348,5300,0.335,0.123,0.579,12.3%,57.9%
0500000US47013,47013,47,13,"Campbell County, Tennessee",40716,472,40244,39846,39510,117,101,103,10,5,398,0.058,0500000US47013,Campbell County,39272,500,38772,37489,37101,130,77,94,0,87,1283,0.106,0.048,0.828,4.8%,82.8%
0500000US47015,47015,47,15,"Cannon County, Tennessee",13801,210,13591,13421,13190,167,26,19,9,10,170,0.086,0500000US47015,Cannon County,14506,395,14111,13364,13064,192,25,38,4,41,747,0.185,0.099,1.154,9.9%,115.4%
0500000US47017,47017,47,17,"Carroll County, Tennessee",28522,595,27927,27514,24455,2851,108,51,8,41,413,0.254,0500000US47017,Carroll County,28440,769,27671,26497,23744,2445,75,124,5,104,1174,0.293,0.039,0.153,3.9%,15.3%
0500000US47019,47019,47,19,"Carter County, Tennessee",57424,890,56534,55939,54849,743,110,180,8,49,595,0.087,0500000US47019,Carter County,56356,1181,55175,52991,51790,702,153,231,7,108,2184,0.153,0.066,0.760,6.6%,76.0%
0500000US47021,47021,47,21,"Cheatham County, Tennessee",39105,910,38195,37764,36914,552,115,139,13,31,431,0.108,0500000US47021,Cheatham County,41072,1839,39233,37542,36299,815,92,184,25,127,1691,0.215,0.107,0.988,10.7%,98.8%
0500000US47023,47023,47,23,"Chester County, Tennessee",17131,343,16788,16538,14837,1561,65,53,2,20,250,0.241,0500000US47023,Chester County,17341,528,16813,16149,14471,1494,52,70,0,62,664,0.294,0.053,0.219,5.3%,21.9%
0500000US47025,47025,47,25,"Claiborne County, Tennessee",32213,265,31948,31609,31051,280,91,165,5,17,339,0.071,0500000US47025,Claiborne County,32043,490,31553,30584,29966,314,58,148,11,87,969,0.124,0.054,0.760,5.4%,76.0%
0500000US47027,47027,47,27,"Clay County, Tennessee",7861,126,7735,7651,7524,100,16,7,1,3,84,0.083,0500000US47027,Clay County,7581,130,7451,7305,7202,76,17,5,1,4,146,0.097,0.013,0.160,1.3%,16.0%
0500000US47029,47029,47,29,"Cocke County, Tennessee",35662,628,35034,34505,33598,659,113,105,19,11,529,0.112,0500000US47029,Cocke County,35999,954,35045,33646,32733,582,126,150,9,46,1399,0.171,0.059,0.531,5.9%,53.1%
0500000US47031,47031,47,31,"Coffee County, Tennessee",52796,2007,50789,49993,47539,1820,145,449,17,23,796,0.186,0500000US47031,Coffee County,57889,3259,54630,52044,48983,2097,145,611,37,171,2586,0.277,0.091,0.489,9.1%,48.9%
0500000US47033,47033,47,33,"Crockett County, Tennessee",14586,1274,13312,13147,11253,1837,12,25,4,16,165,0.381,0500000US47033,Crockett County,13911,1498,12413,12030,10056,1879,19,25,1,50,383,0.447,0.066,0.172,6.6%,17.2%
0500000US47035,47035,47,35,"Cumberland County, Tennessee",56053,1307,54746,54285,53712,146,145,237,24,21,461,0.081,0500000US47035,Cumberland County,61145,1936,59209,57222,56313,299,130,366,12,102,1987,0.150,0.069,0.845,6.9%,84.5%
0500000US47037,47037,47,37,"Davidson County, Tennessee",626681,61117,565564,553764,359883,172075,1450,18878,293,1185,11800,0.584,0500000US47037,Davidson County,715884,98119,617765,590806,386835,171489,1309,27660,303,3210,26959,0.629,0.045,0.077,4.5%,7.7%
0500000US47039,47039,47,39,"Decatur County, Tennessee",11757,308,11449,11339,10947,337,23,25,6,1,110,0.131,0500000US47039,Decatur County,11435,358,11077,10803,10462,270,9,42,5,15,274,0.161,0.029,0.223,2.9%,22.3%
0500000US47041,47041,47,41,"DeKalb County, Tennessee",18723,1239,17484,17314,16980,233,35,48,2,16,170,0.173,0500000US47041,DeKalb County,20080,1449,18631,17938,17526,234,44,76,5,53,693,0.232,0.059,0.340,5.9%,34.0%
0500000US47043,47043,47,43,"Dickson County, Tennessee",49666,1573,48093,47332,44880,2035,161,201,15,40,761,0.180,0500000US47043,Dickson County,54315,2582,51733,49580,46994,1931,181,310,4,160,2153,0.246,0.066,0.364,6.6%,36.4%
0500000US47045,47045,47,45,"Dyer County, Tennessee",38335,1002,37333,36764,31044,5433,72,188,8,19,569,0.323,0500000US47045,Dyer County,36801,1303,35498,34012,28272,5335,81,213,11,100,1486,0.386,0.063,0.194,6.3%,19.4%
0500000US47047,47047,47,47,"Fayette County, Tennessee",38413,858,37555,37253,26193,10742,106,186,3,23,302,0.456,0500000US47047,Fayette County,41990,1430,40560,39100,27558,11038,59,269,18,158,1460,0.498,0.041,0.091,4.1%,9.1%
0500000US47049,47049,47,49,"Fentress County, Tennessee",17959,189,17770,17630,17522,26,42,34,4,2,140,0.048,0500000US47049,Fentress County,18489,316,18173,17643,17541,25,26,33,0,18,530,0.099,0.051,1.063,5.1%,106.3%
0500000US47051,47051,47,51,"Franklin County, Tennessee",41052,1029,40023,39406,36839,2086,137,299,19,26,617,0.191,0500000US47051,Franklin County,42774,1502,41272,39545,36864,1962,117,348,17,237,1727,0.252,0.061,0.319,6.1%,31.9%
0500000US47053,47053,47,53,"Gibson County, Tennessee",49683,1012,48671,48108,38571,9307,98,106,4,22,563,0.362,0500000US47053,Gibson County,50429,1439,48990,47283,37930,8929,97,200,15,112,1707,0.401,0.039,0.109,3.9%,10.9%
0500000US47055,47055,47,55,"Giles County, Tennessee",29485,471,29014,28473,25221,3006,95,111,7,33,541,0.257,0500000US47055,Giles County,30346,728,29618,28220,24920,2927,113,176,9,75,1398,0.314,0.056,0.219,5.6%,21.9%
0500000US47057,47057,47,57,"Grainger County, Tennessee",22657,530,22127,21924,21753,101,36,24,3,7,203,0.078,0500000US47057,Grainger County,23527,773,22754,21996,21748,118,42,53,2,33,758,0.143,0.066,0.848,6.6%,84.8%
0500000US47059,47059,47,59,"Greene County, Tennessee",68831,1690,67141,66438,64637,1355,150,249,11,36,703,0.117,0500000US47059,Greene County,70152,2535,67617,65100,63143,1308,142,299,14,194,2517,0.187,0.070,0.597,7.0%,59.7%
0500000US47061,47061,47,61,"Grundy County, Tennessee",13703,113,13590,13449,13321,36,63,24,1,4,141,0.055,0500000US47061,Grundy County,13529,175,13354,12757,12620,38,33,44,0,22,597,0.128,0.073,1.332,7.3%,133.2%
0500000US47063,47063,47,63,"Hamblen County, Tennessee",62544,6711,55833,54908,51846,2394,100,448,67,53,925,0.300,0500000US47063,Hamblen County,64499,9483,55016,52565,49197,2106,130,712,268,152,2451,0.394,0.094,0.315,9.4%,31.5%
0500000US47065,47065,47,65,"Hamilton County, Tennessee",336463,14993,321470,316855,242154,67483,817,5855,150,396,4615,0.439,0500000US47065,Hamilton County,366207,27075,339132,324227,249939,63979,770,8139,131,1269,14905,0.496,0.057,0.129,5.7%,12.9%
0500000US47067,47067,47,67,"Hancock County, Tennessee",6819,13,6806,6728,6673,24,19,7,0,5,78,0.042,0500000US47067,Hancock County,6662,40,6622,6461,6391,33,25,1,0,11,161,0.079,0.037,0.873,3.7%,87.3%
0500000US47069,47069,47,69,"Hardeman County, Tennessee",27253,376,26877,26644,15197,11228,56,145,0,18,233,0.519,0500000US47069,Hardeman County,25462,494,24968,24402,13970,10150,46,162,6,68,566,0.539,0.020,0.039,2.0%,3.9%
0500000US47071,47071,47,71,"Hardin County, Tennessee",26026,497,25529,25183,24110,888,69,102,7,7,346,0.140,0500000US47071,Hardin County,26831,565,26266,25359,24272,805,81,148,0,53,907,0.179,0.039,0.279,3.9%,27.9%
0500000US47073,47073,47,73,"Hawkins County, Tennessee",56833,669,56164,55594,54453,735,100,277,8,21,570,0.082,0500000US47073,Hawkins County,56721,889,55832,53978,52824,671,104,256,13,110,1854,0.131,0.050,0.609,5.0%,60.9%
0500000US47075,47075,47,75,"Haywood County, Tennessee",18787,723,18064,17917,8419,9431,25,21,0,21,147,0.546,0500000US47075,Haywood County,17864,838,17026,16668,7554,8993,33,26,6,56,358,0.565,0.020,0.036,2.0%,3.6%
0500000US47077,47077,47,77,"Henderson County, Tennessee",27769,532,27237,26791,24482,2169,40,76,3,21,446,0.216,0500000US47077,Henderson County,27842,719,27123,26047,23890,1931,53,90,2,81,1076,0.257,0.041,0.189,4.1%,18.9%
0500000US47079,47079,47,79,"Henry County, Tennessee",32330,553,31777,31312,28522,2578,93,95,5,19,465,0.215,0500000US47079,Henry County,32199,877,31322,29967,27250,2307,76,202,7,125,1355,0.276,0.061,0.285,6.1%,28.5%
0500000US47081,47081,47,81,"Hickman County, Tennessee",24690,455,24235,23942,22657,1102,118,47,2,16,293,0.155,0500000US47081,Hickman County,24925,681,24244,23244,22086,931,101,72,1,53,1000,0.211,0.056,0.358,5.6%,35.8%
0500000US47083,47083,47,83,"Houston County, Tennessee",8426,129,8297,8170,7931,190,20,25,3,1,127,0.113,0500000US47083,Houston County,8283,202,8081,7787,7491,200,32,16,8,40,294,0.180,0.067,0.589,6.7%,58.9%
0500000US47085,47085,47,85,"Humphreys County, Tennessee",18538,278,18260,18071,17498,455,65,34,6,13,189,0.108,0500000US47085,Humphreys County,18990,449,18541,17770,17102,494,43,57,0,74,771,0.186,0.078,0.721,7.8%,72.1%
0500000US47087,47087,47,87,"Jackson County, Tennessee",11638,164,11474,11364,11267,29,52,10,1,5,110,0.062,0500000US47087,Jackson County,11617,245,11372,10889,10778,31,35,17,0,28,483,0.137,0.075,1.195,7.5%,119.5%
0500000US47089,47089,47,89,"Jefferson County, Tennessee",51407,1619,49788,49199,47738,1031,152,212,11,55,589,0.136,0500000US47089,Jefferson County,54683,2392,52291,50355,48975,787,159,257,20,157,1936,0.194,0.058,0.429,5.8%,42.9%
0500000US47091,47091,47,91,"Johnson County, Tennessee",18244,269,17975,17818,17373,373,32,35,3,2,157,0.092,0500000US47091,Johnson County,17948,516,17432,16922,16126,724,28,27,9,8,510,0.189,0.097,1.048,9.7%,104.8%
0500000US47093,47093,47,93,"Knox County, Tennessee",432226,15012,417214,410082,362580,37648,1018,7998,277,561,7132,0.287,0500000US47093,Knox County,478971,28568,450403,428679,373790,39853,1079,11881,300,1776,21724,0.378,0.091,0.317,9.1%,31.7%
0500000US47095,47095,47,95,"Lake County, Tennessee",7832,136,7696,7607,5409,2162,20,11,1,4,89,0.446,0500000US47095,Lake County,7005,175,6830,6624,4755,1832,15,12,5,5,206,0.469,0.023,0.051,2.3%,5.1%
0500000US47097,47097,47,97,"Lauderdale County, Tennessee",27815,564,27251,26938,17035,9676,155,55,0,17,313,0.503,0500000US47097,Lauderdale County,25143,587,24556,23649,15016,8385,133,53,0,62,907,0.530,0.027,0.053,2.7%,5.3%
0500000US47099,47099,47,99,"Lawrence County, Tennessee",41869,689,41180,40603,39690,637,142,120,2,12,577,0.101,0500000US47099,Lawrence County,44159,1117,43042,41442,40368,694,92,167,1,120,1600,0.162,0.061,0.610,6.1%,61.0%
0500000US47101,47101,47,101,"Lewis County, Tennessee",12161,221,11940,11790,11507,198,34,43,5,3,150,0.104,0500000US47101,Lewis County,12582,326,12256,11821,11510,184,31,55,5,36,435,0.161,0.057,0.550,5.7%,55.0%
0500000US47103,47103,47,103,"Lincoln County, Tennessee",33361,885,32476,31954,29402,2256,145,115,13,23,522,0.218,0500000US47103,Lincoln County,35319,1268,34051,32392,29803,2198,116,178,16,81,1659,0.281,0.063,0.289,6.3%,28.9%
0500000US47105,47105,47,105,"Loudon County, Tennessee",48556,3395,45161,44737,43776,517,111,284,22,27,424,0.182,0500000US47105,Loudon County,54886,5356,49530,47705,46419,578,95,450,2,161,1825,0.274,0.092,0.504,9.2%,50.4%
0500000US47107,47107,47,107,"McMinn County, Tennessee",52266,1482,50784,49887,47273,2021,158,385,8,42,897,0.179,0500000US47107,McMinn County,53276,2161,51115,48529,45993,1842,140,430,17,107,2586,0.249,0.070,0.391,7.0%,39.1%
0500000US47109,47109,47,109,"McNairy County, Tennessee",26075,396,25679,25370,23716,1541,47,49,1,16,309,0.169,0500000US47109,McNairy County,25866,438,25428,24576,22847,1545,55,78,0,51,852,0.215,0.046,0.272,4.6%,27.2%
0500000US47111,47111,47,111,"Macon County, Tennessee",22248,919,21329,21152,20961,79,61,44,3,4,177,0.111,0500000US47111,Macon County,25216,1684,23532,22705,22439,120,60,44,8,34,827,0.203,0.092,0.832,9.2%,83.2%
0500000US47113,47113,47,113,"Madison County, Tennessee",98294,3306,94988,93775,57060,35530,146,895,28,116,1213,0.531,0500000US47113,Madison County,98823,4722,94101,90875,53264,35837,175,1227,13,359,3226,0.574,0.043,0.082,4.3%,8.2%
0500000US47115,47115,47,115,"Marion County, Tennessee",28237,361,27876,27564,26328,1007,111,111,1,6,312,0.129,0500000US47115,Marion County,28837,601,28236,27018,25689,1033,93,148,2,53,1218,0.203,0.074,0.572,7.4%,57.2%
0500000US47117,47117,47,117,"Marshall County, Tennessee",30617,1386,29231,28823,26565,1985,100,130,15,28,408,0.241,0500000US47117,Marshall County,34318,2235,32083,30618,28255,2018,103,142,7,93,1465,0.313,0.072,0.299,7.2%,29.9%
0500000US47119,47119,47,119,"Maury County, Tennessee",80956,3909,77047,75792,64919,10076,232,482,21,62,1255,0.339,0500000US47119,Maury County,100974,7660,93314,89033,76182,11241,248,934,45,383,4281,0.411,0.072,0.212,7.2%,21.2%
0500000US47121,47121,47,121,"Meigs County, Tennessee",11753,176,11577,11455,11261,116,58,18,0,2,122,0.082,0500000US47121,Meigs County,12758,220,12538,12077,11823,131,58,26,1,38,461,0.139,0.058,0.711,5.8%,71.1%
0500000US47123,47123,47,123,"Monroe County, Tennessee",44519,1448,43071,42417,41146,900,199,151,10,11,654,0.144,0500000US47123,Monroe County,46250,1937,44313,42343,41185,736,141,194,2,85,1970,0.203,0.059,0.410,5.9%,41.0%
0500000US47125,47125,47,125,"Montgomery County, Tennessee",172331,13752,158579,152697,115553,32003,782,3480,634,245,5882,0.508,0500000US47125,Montgomery County,220069,22934,197135,182582,131294,43349,757,5039,936,1207,14553,0.589,0.082,0.160,8.2%,16.0%
0500000US47127,47127,47,127,"Moore County, Tennessee",6362,70,6292,6227,6037,145,16,24,1,4,65,0.099,0500000US47127,Moore County,6461,101,6360,6159,5999,103,17,29,1,10,201,0.136,0.038,0.381,3.8%,38.1%
0500000US47129,47129,47,129,"Morgan County, Tennessee",21987,188,21799,21551,20638,803,65,38,6,1,248,0.117,0500000US47129,Morgan County,21035,299,20736,20167,19029,971,54,41,8,64,569,0.179,0.061,0.521,6.1%,52.1%
0500000US47131,47131,47,131,"Obion County, Tennessee",31807,999,30808,30490,26988,3353,49,75,8,17,318,0.268,0500000US47131,Obion County,30787,1574,29213,28093,24736,3137,50,103,0,67,1120,0.340,0.072,0.270,7.2%,27.0%
0500000US47133,47133,47,133,"Overton County, Tennessee",22083,202,21881,21656,21452,86,65,43,1,9,225,0.056,0500000US47133,Overton County,22511,344,22167,21461,21223,86,60,61,0,31,706,0.110,0.054,0.959,5.4%,95.9%
0500000US47135,47135,47,135,"Perry County, Tennessee",7915,131,7784,7677,7502,116,43,14,0,2,107,0.101,0500000US47135,Perry County,8366,127,8239,7984,7700,195,41,26,1,21,255,0.151,0.050,0.497,5.0%,49.7%
0500000US47137,47137,47,137,"Pickett County, Tennessee",5077,67,5010,4984,4964,5,11,4,0,0,26,0.044,0500000US47137,Pickett County,5001,83,4918,4848,4811,8,8,15,1,5,70,0.074,0.030,0.690,3.0%,69.0%
0500000US47139,47139,47,139,"Polk County, Tennessee",16825,233,16592,16396,16262,50,57,23,1,3,196,0.065,0500000US47139,Polk County,17544,297,17247,16499,16313,61,59,33,10,23,748,0.133,0.068,1.036,6.8%,103.6%
0500000US47141,47141,47,141,"Putnam County, Tennessee",72321,3858,68463,67577,65052,1421,211,839,18,36,886,0.187,0500000US47141,Putnam County,79854,6256,73598,70402,66782,2161,161,1086,33,179,3196,0.292,0.105,0.558,10.5%,55.8%
0500000US47143,47143,47,143,"Rhea County, Tennessee",31809,1187,30622,30205,29303,609,126,128,14,25,417,0.149,0500000US47143,Rhea County,32870,1960,30910,29609,28641,598,100,195,6,69,1301,0.235,0.086,0.575,8.6%,57.5%
0500000US47145,47145,47,145,"Roane County, Tennessee",54181,710,53471,52662,50752,1430,167,274,15,24,809,0.121,0500000US47145,Roane County,53404,1011,52393,50074,48094,1302,161,341,19,157,2319,0.186,0.065,0.532,6.5%,53.2%
0500000US47147,47147,47,147,"Robertson County, Tennessee",66283,3903,62380,61615,56159,4877,190,323,17,49,765,0.273,0500000US47147,Robertson County,72803,6878,65925,62993,57049,5091,139,447,21,246,2932,0.370,0.097,0.357,9.7%,35.7%
0500000US47149,47149,47,149,"Rutherford County, Tennessee",262604,17500,245104,240041,198483,32534,671,7901,116,336,5063,0.408,0500000US47149,Rutherford County,341486,38317,303169,287508,219194,53270,789,12394,219,1642,15661,0.548,0.140,0.343,14.0%,34.3%
0500000US47151,47151,47,151,"Scott County, Tennessee",22228,120,22108,21925,21795,19,55,42,1,13,183,0.038,0500000US47151,Scott County,21850,205,21645,21082,20957,32,36,51,0,6,563,0.079,0.041,1.061,4.1%,106.1%
0500000US47153,47153,47,153,"Sequatchie County, Tennessee",14112,462,13650,13516,13402,19,47,40,4,4,134,0.097,0500000US47153,Sequatchie County,15826,621,15205,14641,14409,72,49,65,4,42,564,0.168,0.071,0.736,7.1%,73.6%
0500000US47155,47155,47,155,"Sevier County, Tennessee",89889,4787,85102,84164,82374,640,295,769,15,71,938,0.157,0500000US47155,Sevier County,98380,8614,89766,86260,83801,766,312,1103,24,254,3506,0.265,0.108,0.688,10.8%,68.8%
0500000US47157,47157,47,157,"Shelby County, Tennessee",927644,52092,875552,864957,359106,481431,1804,21245,274,1097,10595,0.577,0500000US47157,Shelby County,929744,77707,852037,825205,316740,475074,1561,27960,256,3614,26832,0.614,0.037,0.064,3.7%,6.4%
0500000US47159,47159,47,159,"Smith County, Tennessee",19166,417,18749,18527,18002,405,81,32,3,4,222,0.117,0500000US47159,Smith County,19904,518,19386,18575,18054,356,61,84,0,20,811,0.175,0.058,0.496,5.8%,49.6%
0500000US47161,47161,47,161,"Stewart County, Tennessee",13324,250,13074,12873,12469,187,75,135,3,4,201,0.123,0500000US47161,Stewart County,13657,336,13321,12689,12321,171,74,76,2,45,632,0.183,0.060,0.485,6.0%,48.5%
0500000US47163,47163,47,163,"Sullivan County, Tennessee",156823,2321,154502,152703,148033,3272,379,881,28,110,1799,0.108,0500000US47163,Sullivan County,158163,3548,154615,148664,143354,3197,350,1270,36,457,5951,0.176,0.068,0.628,6.8%,62.8%
0500000US47165,47165,47,165,"Sumner County, Tennessee",160645,6308,154337,152189,139693,10213,406,1616,93,168,2148,0.238,0500000US47165,Sumner County,196281,12870,183411,174885,155169,15537,476,2932,116,655,8526,0.362,0.124,0.523,12.4%,52.3%
0500000US47167,47167,47,167,"Tipton County, Tennessee",61081,1269,59812,58904,46831,11393,217,356,48,59,908,0.377,0500000US47167,Tipton County,60970,1686,59284,56487,44925,10760,180,393,39,190,2797,0.423,0.046,0.123,4.6%,12.3%
0500000US47169,47169,47,169,"Trousdale County, Tennessee",7870,198,7672,7554,6761,748,23,18,1,3,118,0.252,0500000US47169,Trousdale County,11615,375,11240,10776,8786,1917,26,27,0,20,464,0.398,0.146,0.579,14.6%,57.9%
0500000US47171,47171,47,171,"Unicoi County, Tennessee",18313,694,17619,17461,17348,35,41,30,2,5,158,0.101,0500000US47171,Unicoi County,17928,1107,16821,16315,16175,44,38,37,0,21,506,0.181,0.080,0.794,8.0%,79.4%
0500000US47173,47173,47,173,"Union County, Tennessee",19109,249,18860,18631,18539,21,44,19,3,5,229,0.058,0500000US47173,Union County,19802,404,19398,18810,18642,53,33,36,5,41,588,0.112,0.054,0.923,5.4%,92.3%
0500000US47175,47175,47,175,"Van Buren County, Tennessee",5548,50,5498,5450,5408,22,13,7,0,0,48,0.050,0500000US47175,Van Buren County,6168,83,6085,5904,5866,20,7,10,1,0,181,0.094,0.045,0.903,4.5%,90.3%
0500000US47177,47177,47,177,"Warren County, Tennessee",39839,3224,36615,36153,34739,1085,95,190,12,32,462,0.232,0500000US47177,Warren County,40953,3943,37010,35560,33980,1090,84,258,10,138,1450,0.300,0.068,0.293,6.8%,29.3%
0500000US47179,47179,47,179,"Washington County, Tennessee",122979,3633,119346,117554,110902,4727,323,1461,25,116,1792,0.184,0500000US47179,Washington County,133001,6136,126865,121045,112606,5511,289,1980,53,606,5820,0.277,0.093,0.506,9.3%,50.6%
0500000US47181,47181,47,181,"Wayne County, Tennessee",17021,277,16744,16604,15535,975,51,30,2,11,140,0.163,0500000US47181,Wayne County,16232,379,15853,15481,14503,878,18,27,1,54,372,0.198,0.034,0.210,3.4%,21.0%
0500000US47183,47183,47,183,"Weakley County, Tennessee",35021,700,34321,33891,30696,2717,89,365,6,18,430,0.225,0500000US47183,Weakley County,32902,905,31997,30732,27813,2593,52,192,3,79,1265,0.277,0.052,0.230,5.2%,23.0%
0500000US47185,47185,47,185,"White County, Tennessee",25841,425,25416,25110,24496,450,66,69,20,9,306,0.101,0500000US47185,White County,27351,736,26615,25511,24833,405,75,132,10,56,1104,0.173,0.072,0.719,7.2%,71.9%
0500000US47187,47187,47,187,"Williamson County, Tennessee",183182,8166,175016,172726,158769,7828,343,5497,75,214,2290,0.244,0500000US47187,Williamson County,247726,14261,233465,224524,200408,9709,393,12879,115,1020,8941,0.337,0.093,0.380,9.3%,38.0%
0500000US47189,47189,47,189,"Wilson County, Tennessee",113993,3691,110302,108723,99717,7234,353,1259,34,126,1579,0.229,0500000US47189,Wilson County,147737,8375,139362,133125,118889,10099,405,3086,44,602,6237,0.342,0.113,0.492,11.3%,49.2%
0500000US48001,48001,48,1,"Anderson County, Texas",58458,9287,49171,48542,35792,12222,192,283,16,37,629,0.556,0500000US48001,Anderson County,57922,11111,46811,45228,33098,11430,193,381,13,113,1583,0.597,0.041,0.074,4.1%,7.4%
0500000US48003,48003,48,3,"Andrews County, Texas",14786,7195,7591,7480,7083,199,95,85,1,17,111,0.533,0500000US48003,Andrews County,18610,10400,8210,7844,7405,192,96,102,0,49,366,0.529,-0.005,-0.009,-0.5%,-0.9%
0500000US48005,48005,48,5,"Angelina County, Texas",86771,17145,69626,68831,54889,12840,255,744,9,94,795,0.539,0500000US48005,Angelina County,86395,19732,66663,64159,49970,12872,200,891,30,196,2504,0.590,0.051,0.095,5.1%,9.5%
0500000US48007,48007,48,7,"Aransas County, Texas",23158,5690,17468,17195,16350,258,118,443,5,21,273,0.441,0500000US48007,Aransas County,23830,6158,17672,16772,15816,241,142,480,15,78,900,0.491,0.050,0.114,5.0%,11.4%
0500000US48009,48009,48,9,"Archer County, Texas",9054,675,8379,8288,8182,34,47,18,3,4,91,0.178,0500000US48009,Archer County,8560,742,7818,7496,7356,30,71,18,0,21,322,0.253,0.075,0.421,7.5%,42.1%
0500000US48011,48011,48,11,"Armstrong County, Texas",1901,124,1777,1760,1725,11,13,0,0,11,17,0.172,0500000US48011,Armstrong County,1848,144,1704,1628,1593,6,17,10,0,2,76,0.249,0.077,0.447,7.7%,44.7%
0500000US48013,48013,48,13,"Atascosa County, Texas",44911,27785,17126,16881,16295,256,143,130,14,43,245,0.486,0500000US48013,Atascosa County,48981,31178,17803,16884,16066,340,116,170,15,177,919,0.487,0.001,0.003,0.1%,0.3%
0500000US48015,48015,48,15,"Austin County, Texas",28417,6641,21776,21505,18657,2622,79,110,1,36,271,0.506,0500000US48015,Austin County,30167,8052,22115,21226,18480,2352,78,201,8,107,889,0.546,0.041,0.081,4.1%,8.1%
0500000US48017,48017,48,17,"Bailey County, Texas",7165,4283,2882,2853,2745,67,16,23,0,2,29,0.496,0500000US48017,Bailey County,6904,4540,2364,2298,2190,49,24,8,0,27,66,0.467,-0.029,-0.058,-2.9%,-5.8%
0500000US48019,48019,48,19,"Bandera County, Texas",20485,3415,17070,16860,16576,90,121,55,0,18,210,0.317,0500000US48019,Bandera County,20851,4010,16841,15975,15595,102,101,95,11,71,866,0.402,0.085,0.266,8.5%,26.6%
0500000US48021,48021,48,21,"Bastrop County, Texas",74171,24190,49981,48914,42446,5535,315,449,54,115,1067,0.560,0500000US48021,Bastrop County,97216,41484,55732,52721,45751,5460,312,718,63,417,3011,0.592,0.032,0.057,3.2%,5.7%
0500000US48023,48023,48,23,"Baylor County, Texas",3726,455,3271,3236,3147,71,10,4,3,1,35,0.271,0500000US48023,Baylor County,3465,439,3026,2877,2797,52,11,9,0,8,149,0.330,0.059,0.217,5.9%,21.7%
0500000US48025,48025,48,25,"Bee County, Texas",31861,17906,13955,13772,10967,2525,70,162,10,38,183,0.559,0500000US48025,Bee County,31047,19392,11655,11248,8600,2316,54,211,2,65,407,0.527,-0.032,-0.057,-3.2%,-5.7%
0500000US48027,48027,48,27,"Bell County, Texas",310235,67010,243225,233248,157289,63380,1484,8350,2245,500,9977,0.653,0500000US48027,Bell County,370647,93467,277180,255388,156780,80759,1448,10884,3454,2063,21792,0.706,0.053,0.081,5.3%,8.1%
0500000US48029,48029,48,29,"Bexar County, Texas",1714773,1006958,707815,685640,519123,118460,3809,39561,1806,2881,22175,0.558,0500000US48029,Bexar County,2009324,1190958,818366,764322,535732,147875,4554,65217,2726,8218,54044,0.570,0.012,0.022,1.2%,2.2%
0500000US48031,48031,48,31,"Blanco County, Texas",10497,1909,8588,8503,8336,62,47,49,4,5,85,0.336,0500000US48031,Blanco County,11374,2092,9282,8919,8707,68,36,38,0,70,363,0.379,0.043,0.128,4.3%,12.8%
0500000US48033,48033,48,33,"Borden County, Texas",641,95,546,542,539,0,2,1,0,0,4,0.271,0500000US48033,Borden County,631,86,545,530,528,1,0,0,0,1,15,0.281,0.010,0.036,1.0%,3.6%
0500000US48035,48035,48,35,"Bosque County, Texas",18212,2926,15286,15101,14701,277,74,38,2,9,185,0.322,0500000US48035,Bosque County,18235,3321,14914,14060,13621,244,83,80,3,29,854,0.406,0.084,0.261,8.4%,26.1%
0500000US48037,48037,48,37,"Bowie County, Texas",92565,6062,86503,84999,61343,22230,572,721,45,88,1504,0.498,0500000US48037,Bowie County,92893,7602,85291,80976,55855,23084,554,1082,69,332,4315,0.568,0.069,0.139,6.9%,13.9%
0500000US48039,48039,48,39,"Brazoria County, Texas",313166,86643,226523,222110,166674,36880,1013,17013,58,472,4413,0.623,0500000US48039,Brazoria County,372031,115202,256829,244257,161833,53668,1022,26231,129,1374,12572,0.688,0.065,0.104,6.5%,10.4%
0500000US48041,48041,48,41,"Brazos County, Texas",194851,45405,149446,146873,115252,20827,484,9982,82,246,2573,0.582,0500000US48041,Brazos County,233849,63067,170782,162946,123035,23569,502,14621,210,1009,7836,0.635,0.054,0.092,5.4%,9.2%
0500000US48043,48043,48,43,"Brewster County, Texas",9232,3918,5314,5202,5011,79,38,58,5,11,112,0.525,0500000US48043,Brewster County,9546,3963,5583,5301,4948,162,30,94,11,56,282,0.558,0.033,0.062,3.3%,6.2%
0500000US48045,48045,48,45,"Briscoe County, Texas",1637,411,1226,1205,1163,40,2,0,0,0,21,0.431,0500000US48045,Briscoe County,1435,368,1067,1032,1008,17,4,0,0,3,35,0.440,0.009,0.020,0.9%,2.0%
0500000US48047,48047,48,47,"Brooks County, Texas",7223,6590,633,624,573,19,10,18,0,4,9,0.161,0500000US48047,Brooks County,7076,6242,834,782,724,8,9,29,0,12,52,0.211,0.050,0.310,5.0%,31.0%
0500000US48049,48049,48,49,"Brown County, Texas",38106,7453,30653,30161,28478,1303,170,160,14,36,492,0.402,0500000US48049,Brown County,38095,8211,29884,28551,26672,1353,134,269,27,96,1333,0.461,0.059,0.147,5.9%,14.7%
0500000US48051,48051,48,51,"Burleson County, Texas",17187,3166,14021,13843,11696,2064,48,25,3,7,178,0.488,0500000US48051,Burleson County,17642,3712,13930,13279,11258,1852,65,70,0,34,651,0.536,0.048,0.098,4.8%,9.8%
0500000US48053,48053,48,53,"Burnet County, Texas",42750,8652,34098,33654,32530,700,169,198,13,44,444,0.380,0500000US48053,Burnet County,49130,11199,37931,36157,34810,579,183,424,14,147,1774,0.444,0.065,0.171,6.5%,17.1%
0500000US48055,48055,48,55,"Caldwell County, Texas",38066,17922,20144,19793,16841,2456,90,344,8,54,351,0.578,0500000US48055,Caldwell County,45883,25468,20415,19323,16560,2225,129,227,4,178,1092,0.559,-0.020,-0.034,-2.0%,-3.4%
0500000US48057,48057,48,57,"Calhoun County, Texas",21381,9922,11459,11311,9794,519,36,943,4,15,148,0.572,0500000US48057,Calhoun County,20106,9858,10248,9937,8374,361,34,1112,0,56,311,0.583,0.010,0.018,1.0%,1.8%
0500000US48059,48059,48,59,"Callahan County, Texas",13544,1025,12519,12334,12065,135,61,56,7,10,185,0.200,0500000US48059,Callahan County,13708,1306,12402,11848,11555,118,66,52,7,50,554,0.279,0.078,0.390,7.8%,39.0%
0500000US48061,48061,48,61,"Cameron County, Texas",406220,357747,48473,47757,43427,1192,385,2486,76,191,716,0.213,0500000US48061,Cameron County,421017,376680,44337,42399,37107,1405,365,2596,80,846,1938,0.192,-0.021,-0.100,-2.1%,-10.0%
0500000US48063,48063,48,63,"Camp County, Texas",12401,2648,9753,9549,7298,2133,38,59,17,4,204,0.578,0500000US48063,Camp County,12464,3222,9242,8786,6734,1877,28,105,8,34,456,0.617,0.039,0.067,3.9%,6.7%
0500000US48065,48065,48,65,"Carson County, Texas",6182,525,5657,5583,5473,35,56,19,0,0,74,0.209,0500000US48065,Carson County,5807,558,5249,4965,4873,19,46,19,1,7,284,0.284,0.075,0.361,7.5%,36.1%
0500000US48067,48067,48,67,"Cass County, Texas",30464,1053,29411,29062,23522,5299,133,89,4,15,349,0.372,0500000US48067,Cass County,28454,1336,27118,25916,21028,4518,155,119,10,86,1202,0.425,0.052,0.141,5.2%,14.1%
0500000US48069,48069,48,69,"Castro County, Texas",8062,4828,3234,3217,3004,149,29,30,0,5,17,0.502,0500000US48069,Castro County,7371,4784,2587,2497,2328,95,39,22,4,9,90,0.479,-0.023,-0.047,-2.3%,-4.7%
0500000US48071,48071,48,71,"Chambers County, Texas",35096,6635,28461,28082,24767,2817,134,326,13,25,379,0.460,0500000US48071,Chambers County,46571,10952,35619,34004,29858,3148,161,622,0,215,1615,0.528,0.068,0.148,6.8%,14.8%
0500000US48073,48073,48,73,"Cherokee County, Texas",50845,10499,40346,39681,31892,7401,125,221,6,36,665,0.543,0500000US48073,Cherokee County,50412,11797,38615,36986,30095,6359,128,263,18,123,1629,0.572,0.029,0.054,2.9%,5.4%
0500000US48075,48075,48,75,"Childress County, Texas",7041,1885,5156,5097,4327,684,28,47,2,9,59,0.541,0500000US48075,Childress County,6664,1942,4722,4513,3852,572,20,51,2,16,209,0.573,0.031,0.058,3.1%,5.8%
0500000US48077,48077,48,77,"Clay County, Texas",10752,467,10285,10143,9941,53,115,28,1,5,142,0.143,0500000US48077,Clay County,10218,641,9577,9135,8941,35,78,50,0,31,442,0.228,0.085,0.598,8.5%,59.8%
0500000US48079,48079,48,79,"Cochran County, Texas",3127,1654,1473,1457,1329,110,12,3,3,0,16,0.538,0500000US48079,Cochran County,2547,1527,1020,980,912,62,6,0,0,0,40,0.512,-0.027,-0.050,-2.7%,-5.0%
0500000US48081,48081,48,81,"Coke County, Texas",3320,602,2718,2683,2651,7,19,5,1,0,35,0.329,0500000US48081,Coke County,3285,661,2624,2508,2473,7,15,1,6,6,116,0.392,0.062,0.189,6.2%,18.9%
0500000US48083,48083,48,83,"Coleman County, Texas",8895,1419,7476,7386,7123,186,40,32,1,4,90,0.333,0500000US48083,Coleman County,7684,1192,6492,6252,6013,142,36,32,0,29,240,0.362,0.029,0.089,2.9%,8.9%
0500000US48085,48085,48,85,"Collin County, Texas",782341,115354,666987,650512,493492,64715,3278,87276,387,1364,16475,0.561,0500000US48085,Collin County,1064465,169158,895307,848334,542472,108100,3874,188365,613,4910,46973,0.671,0.111,0.198,11.1%,19.8%
0500000US48087,48087,48,87,"Collingsworth County, Texas",3057,916,2141,2108,1937,122,41,3,0,5,33,0.507,0500000US48087,Collingsworth County,2652,832,1820,1756,1617,108,23,7,1,0,64,0.527,0.021,0.041,2.1%,4.1%
0500000US48089,48089,48,89,"Colorado County, Texas",20874,5452,15422,15271,12496,2636,24,75,15,25,151,0.557,0500000US48089,Colorado County,20557,5990,14567,14117,11761,2222,13,80,0,41,450,0.576,0.018,0.033,1.8%,3.3%
0500000US48091,48091,48,91,"Comal County, Texas",108472,26989,81483,80311,77387,1606,355,813,45,105,1172,0.429,0500000US48091,Comal County,161501,43590,117911,112019,105250,3584,514,1844,127,700,5892,0.500,0.072,0.167,7.2%,16.7%
0500000US48093,48093,48,93,"Comanche County, Texas",13974,3605,10369,10263,10145,25,47,34,4,8,106,0.406,0500000US48093,Comanche County,13594,3867,9727,9350,9197,39,49,38,3,24,377,0.461,0.054,0.134,5.4%,13.4%
0500000US48095,48095,48,95,"Concho County, Texas",4087,2173,1914,1901,1810,57,13,14,5,2,13,0.521,0500000US48095,Concho County,3303,1033,2270,2211,2097,69,9,19,1,16,59,0.498,-0.023,-0.043,-2.3%,-4.3%
0500000US48097,48097,48,97,"Cooke County, Texas",38437,5997,32440,31908,30255,1018,303,278,19,35,532,0.355,0500000US48097,Cooke County,41668,8519,33149,31390,29404,1181,360,307,13,125,1759,0.458,0.102,0.288,10.2%,28.8%
0500000US48099,48099,48,99,"Coryell County, Texas",75388,11973,63415,60820,46776,11450,439,1332,632,191,2595,0.565,0500000US48099,Coryell County,83093,16482,66611,61633,46213,11760,414,1816,1041,389,4978,0.627,0.062,0.110,6.2%,11.0%
0500000US48101,48101,48,101,"Cottle County, Texas",1505,316,1189,1180,1043,129,4,0,1,3,9,0.468,0500000US48101,Cottle County,1380,327,1053,1001,902,96,2,0,1,0,52,0.510,0.042,0.090,4.2%,9.0%
0500000US48103,48103,48,103,"Crane County, Texas",4375,2409,1966,1940,1761,122,34,13,0,10,26,0.534,0500000US48103,Crane County,4675,3158,1517,1449,1342,70,14,22,0,1,68,0.461,-0.073,-0.137,-7.3%,-13.7%
0500000US48105,48105,48,105,"Crockett County, Texas",3719,2352,1367,1348,1312,13,8,11,0,4,19,0.476,0500000US48105,Crockett County,3098,1920,1178,1126,1080,18,9,10,0,9,52,0.494,0.019,0.039,1.9%,3.9%
0500000US48107,48107,48,107,"Crosby County, Texas",6059,3171,2888,2851,2625,199,13,4,2,8,37,0.537,0500000US48107,Crosby County,5133,2829,2304,2219,2076,117,8,12,0,6,85,0.532,-0.005,-0.010,-0.5%,-1.0%
0500000US48109,48109,48,109,"Culberson County, Texas",2398,1827,571,547,504,8,13,22,0,0,24,0.375,0500000US48109,Culberson County,2188,1645,543,507,445,20,11,28,0,3,36,0.393,0.018,0.047,1.8%,4.7%
0500000US48111,48111,48,111,"Dallam County, Texas",6703,2717,3986,3900,3726,81,34,37,5,17,86,0.526,0500000US48111,Dallam County,7115,3707,3408,3267,3119,74,51,10,3,10,141,0.536,0.009,0.018,0.9%,1.8%
0500000US48113,48113,48,113,"Dallas County, Texas",2368139,905940,1462199,1432772,784693,518732,7330,117797,874,3346,29427,0.693,0500000US48113,Dallas County,2613539,1057835,1555704,1488950,724987,564741,6743,181314,1175,9990,66754,0.707,0.014,0.020,1.4%,2.0%
0500000US48115,48115,48,115,"Dawson County, Texas",13833,7387,6446,6351,5402,860,28,46,2,13,95,0.558,0500000US48115,Dawson County,12456,6767,5689,5537,4590,847,23,56,4,17,152,0.564,0.006,0.011,0.6%,1.1%
0500000US48117,48117,48,117,"Deaf Smith County, Texas",19372,13039,6333,6236,5939,158,52,56,2,29,97,0.453,0500000US48117,Deaf Smith County,18583,13925,4658,4471,4233,107,47,44,0,40,187,0.386,-0.066,-0.147,-6.6%,-14.7%
0500000US48119,48119,48,119,"Delta County, Texas",5231,288,4943,4826,4351,375,59,30,0,11,117,0.299,0500000US48119,Delta County,5230,394,4836,4615,4189,312,42,37,5,30,221,0.347,0.048,0.160,4.8%,16.0%
0500000US48121,48121,48,121,"Denton County, Texas",662614,120836,541778,528742,426887,54034,3143,43091,411,1176,13036,0.540,0500000US48121,Denton County,906422,182778,723644,681924,485646,95386,3582,92751,650,3909,41720,0.649,0.108,0.200,10.8%,20.0%
0500000US48123,48123,48,123,"DeWitt County, Texas",20097,6502,13595,13446,11482,1781,43,44,0,96,149,0.561,0500000US48123,DeWitt County,19824,6890,12934,12550,10854,1557,32,70,2,35,384,0.573,0.012,0.021,1.2%,2.1%
0500000US48125,48125,48,125,"Dickens County, Texas",2444,708,1736,1721,1590,92,21,18,0,0,15,0.491,0500000US48125,Dickens County,1770,512,1258,1206,1178,18,0,1,2,7,52,0.472,-0.019,-0.038,-1.9%,-3.8%
0500000US48127,48127,48,127,"Dimmit County, Texas",9996,8616,1380,1366,1217,81,7,51,0,10,14,0.242,0500000US48127,Dimmit County,8615,7487,1128,1068,898,72,8,68,10,12,60,0.234,-0.008,-0.035,-0.8%,-3.5%
0500000US48129,48129,48,129,"Donley County, Texas",3677,309,3368,3325,3136,163,15,9,2,0,43,0.263,0500000US48129,Donley County,3258,356,2902,2748,2537,167,27,10,1,6,154,0.377,0.113,0.430,11.3%,43.0%
0500000US48131,48131,48,131,"Duval County, Texas",11782,10424,1358,1338,1206,86,18,17,5,6,20,0.207,0500000US48131,Duval County,9831,7962,1869,1148,937,145,13,45,0,8,721,0.329,0.123,0.594,12.3%,59.4%
0500000US48133,48133,48,133,"Eastland County, Texas",18583,2673,15910,15759,15271,318,92,62,8,8,151,0.304,0500000US48133,Eastland County,17725,2934,14791,14221,13653,335,96,95,16,26,570,0.378,0.074,0.244,7.4%,24.4%
0500000US48135,48135,48,135,"Ector County, Texas",137130,72331,64799,63703,56306,5596,623,1004,106,68,1096,0.551,0500000US48135,Ector County,165171,100051,65120,62097,51023,7430,568,2257,327,492,3023,0.535,-0.016,-0.030,-1.6%,-3.0%
0500000US48137,48137,48,137,"Edwards County, Texas",2002,1027,975,971,947,10,11,3,0,0,4,0.513,0500000US48137,Edwards County,1422,718,704,672,651,2,5,11,1,2,32,0.535,0.022,0.043,2.2%,4.3%
0500000US48139,48139,48,139,"Ellis County, Texas",149610,35161,114449,112766,97987,13161,565,811,87,155,1683,0.508,0500000US48139,Ellis County,192455,52032,140423,133460,106495,23738,710,1525,202,790,6963,0.604,0.096,0.189,9.6%,18.9%
0500000US48141,48141,48,141,"El Paso County, Texas",800647,658134,142513,137122,105246,20649,2269,7551,805,602,5391,0.306,0500000US48141,El Paso County,865657,715351,150306,139640,98219,24415,2365,10692,1527,2422,10666,0.303,-0.003,-0.010,-0.3%,-1.0%
0500000US48143,48143,48,143,"Erath County, Texas",37890,7279,30611,30253,29382,431,170,240,12,18,358,0.361,0500000US48143,Erath County,42545,9254,33291,31880,30006,1194,215,348,13,104,1411,0.453,0.092,0.254,9.2%,25.4%
0500000US48145,48145,48,145,"Falls County, Texas",17866,3716,14150,13984,9381,4463,60,46,10,24,166,0.619,0500000US48145,Falls County,16968,3965,13003,12571,8707,3708,55,51,8,42,432,0.634,0.015,0.024,1.5%,2.4%
0500000US48147,48147,48,147,"Fannin County, Texas",33915,3226,30689,30151,27433,2273,294,122,6,23,538,0.332,0500000US48147,Fannin County,35662,4218,31444,29827,27042,2199,309,145,20,112,1617,0.405,0.073,0.221,7.3%,22.1%
0500000US48149,48149,48,149,"Fayette County, Texas",24554,4585,19969,19798,18038,1599,69,61,6,25,171,0.421,0500000US48149,Fayette County,24435,5216,19219,18619,17041,1383,50,67,6,72,600,0.464,0.043,0.102,4.3%,10.2%
0500000US48151,48151,48,151,"Fisher County, Texas",3974,999,2975,2947,2797,124,12,7,0,7,28,0.440,0500000US48151,Fisher County,3672,973,2699,2629,2496,92,15,13,2,11,70,0.467,0.026,0.060,2.6%,6.0%
0500000US48153,48153,48,153,"Floyd County, Texas",6446,3410,3036,3017,2777,211,16,11,1,1,19,0.533,0500000US48153,Floyd County,5402,3067,2335,2237,2079,125,7,12,1,13,98,0.529,-0.005,-0.009,-0.5%,-0.9%
0500000US48155,48155,48,155,"Foard County, Texas",1336,187,1149,1145,1087,53,1,4,0,0,4,0.317,0500000US48155,Foard County,1095,197,898,870,845,19,0,3,1,2,28,0.371,0.054,0.171,5.4%,17.1%
0500000US48157,48157,48,157,"Fort Bend County, Texas",585375,138967,446408,436383,211680,123267,1159,98762,174,1341,10025,0.740,0500000US48157,Fort Bend County,822779,198580,624199,598812,243726,167964,1269,181522,276,4055,25387,0.763,0.023,0.031,2.3%,3.1%
0500000US48159,48159,48,159,"Franklin County, Texas",10605,1333,9272,9135,8601,411,65,49,0,9,137,0.325,0500000US48159,Franklin County,10359,1455,8904,8444,7876,394,39,68,6,61,460,0.399,0.074,0.228,7.4%,22.8%
0500000US48161,48161,48,161,"Freestone County, Texas",19816,2694,17122,16960,13656,3164,77,50,5,8,162,0.481,0500000US48161,Freestone County,19435,3155,16280,15744,12817,2740,64,66,11,46,536,0.518,0.037,0.077,3.7%,7.7%
0500000US48163,48163,48,163,"Frio County, Texas",17217,13401,3816,3750,2796,524,38,362,1,29,66,0.366,0500000US48163,Frio County,18385,14171,4214,4096,3053,705,49,199,9,81,118,0.377,0.010,0.028,1.0%,2.8%
0500000US48165,48165,48,165,"Gaines County, Texas",17526,6413,11113,10989,10628,261,46,37,0,17,124,0.498,0500000US48165,Gaines County,21598,8401,13197,12958,12554,241,42,72,3,46,239,0.511,0.012,0.025,1.2%,2.5%
0500000US48167,48167,48,167,"Galveston County, Texas",291309,65270,226039,222002,172652,39229,1052,8515,128,426,4037,0.579,0500000US48167,Galveston County,350682,88636,262046,249394,191358,43120,1036,12202,223,1455,12652,0.621,0.041,0.071,4.1%,7.1%
0500000US48169,48169,48,169,"Garza County, Texas",6461,3046,3415,3391,2962,392,25,8,3,1,24,0.564,0500000US48169,Garza County,5816,3272,2544,2455,2162,230,28,25,0,10,89,0.543,-0.020,-0.036,-2.0%,-3.6%
0500000US48171,48171,48,171,"Gillespie County, Texas",24837,4969,19868,19714,19472,47,68,88,11,28,154,0.345,0500000US48171,Gillespie County,26725,5766,20959,20265,19884,84,69,127,1,100,694,0.399,0.054,0.156,5.4%,15.6%
0500000US48173,48173,48,173,"Glasscock County, Texas",1226,378,848,846,825,15,3,1,2,0,2,0.452,0500000US48173,Glasscock County,1116,387,729,721,710,8,0,0,3,0,8,0.475,0.023,0.051,2.3%,5.1%
0500000US48175,48175,48,175,"Goliad County, Texas",7210,2462,4748,4693,4337,310,29,11,0,6,55,0.520,0500000US48175,Goliad County,7012,2288,4724,4539,4246,235,18,24,0,16,185,0.525,0.005,0.010,0.5%,1.0%
0500000US48177,48177,48,177,"Gonzales County, Texas",19807,9353,10454,10325,8836,1353,41,73,5,17,129,0.573,0500000US48177,Gonzales County,19653,9897,9756,9389,8159,1075,41,63,6,45,367,0.571,-0.003,-0.005,-0.3%,-0.5%
0500000US48179,48179,48,179,"Gray County, Texas",22535,5365,17170,16866,15564,1055,152,83,1,11,304,0.464,0500000US48179,Gray County,21227,6347,14880,14165,13025,835,141,127,0,37,715,0.531,0.067,0.145,6.7%,14.5%
0500000US48181,48181,48,181,"Grayson County, Texas",120877,13688,107189,104793,95103,6938,1603,1034,38,77,2396,0.364,0500000US48181,Grayson County,135543,20868,114675,106899,95211,7448,1876,1958,58,348,7776,0.476,0.112,0.307,11.2%,30.7%
0500000US48183,48183,48,183,"Gregg County, Texas",121730,20018,101712,100040,74005,24068,497,1316,35,119,1672,0.564,0500000US48183,Gregg County,124239,24040,100199,95407,68050,24974,424,1614,47,298,4792,0.620,0.057,0.100,5.7%,10.0%
0500000US48185,48185,48,185,"Grimes County, Texas",26604,5652,20952,20647,16133,4348,82,61,7,16,305,0.560,0500000US48185,Grimes County,29268,7361,21907,21013,16910,3824,85,102,8,84,894,0.585,0.025,0.044,2.5%,4.4%
0500000US48187,48187,48,187,"Guadalupe County, Texas",131533,46889,84644,82556,72086,7963,436,1748,146,177,2088,0.568,0500000US48187,Guadalupe County,172706,65233,107473,100679,84063,11947,476,3066,353,774,6794,0.614,0.045,0.080,4.5%,8.0%
0500000US48189,48189,48,189,"Hale County, Texas",36273,20269,16004,15737,13647,1803,103,133,19,32,267,0.544,0500000US48189,Hale County,32522,19489,13033,12421,10693,1381,99,149,30,69,612,0.531,-0.013,-0.024,-1.3%,-2.4%
0500000US48191,48191,48,191,"Hall County, Texas",3353,1087,2266,2250,1998,235,13,2,0,2,16,0.535,0500000US48191,Hall County,2825,950,1875,1798,1589,190,7,9,0,3,77,0.565,0.030,0.057,3.0%,5.7%
0500000US48193,48193,48,193,"Hamilton County, Texas",8517,863,7654,7599,7495,38,31,31,1,3,55,0.215,0500000US48193,Hamilton County,8222,1045,7177,6929,6805,32,37,36,2,17,248,0.298,0.083,0.384,8.3%,38.4%
0500000US48195,48195,48,195,"Hansford County, Texas",5613,2430,3183,3152,3088,31,11,16,0,6,31,0.510,0500000US48195,Hansford County,5285,2615,2670,2610,2552,12,16,9,3,18,60,0.522,0.012,0.024,1.2%,2.4%
0500000US48197,48197,48,197,"Hardeman County, Texas",4139,889,3250,3183,2938,217,15,12,0,1,67,0.447,0500000US48197,Hardeman County,3549,818,2731,2611,2441,130,14,18,1,7,120,0.471,0.024,0.054,2.4%,5.4%
0500000US48199,48199,48,199,"Hardin County, Texas",54635,2384,52251,51745,48088,3181,182,269,6,19,506,0.220,0500000US48199,Hardin County,56231,3417,52814,50743,46934,3037,190,399,34,149,2071,0.295,0.075,0.343,7.5%,34.3%
0500000US48201,48201,48,201,"Harris County, Texas",4092459,1671540,2420919,2372081,1349646,754258,8150,249853,2260,7914,48838,0.687,0500000US48201,Harris County,4731145,2034709,2696436,2574765,1309593,885517,8432,344762,3199,23262,121671,0.697,0.011,0.016,1.1%,1.6%
0500000US48203,48203,48,203,"Harrison County, Texas",65631,7254,58377,57643,42654,14303,277,331,26,52,734,0.518,0500000US48203,Harrison County,68839,9839,59000,56559,42039,13448,294,483,28,267,2441,0.567,0.049,0.095,4.9%,9.5%
0500000US48205,48205,48,205,"Hartley County, Texas",6062,1448,4614,4585,4111,416,18,29,3,8,29,0.478,0500000US48205,Hartley County,5382,1631,3751,3639,3403,191,15,24,5,1,112,0.507,0.028,0.059,2.8%,5.9%
0500000US48207,48207,48,207,"Haskell County, Texas",5899,1414,4485,4410,4148,203,25,31,0,3,75,0.447,0500000US48207,Haskell County,5416,1377,4039,3888,3628,181,28,22,5,24,151,0.485,0.038,0.085,3.8%,8.5%
0500000US48209,48209,48,209,"Hays County, Texas",157107,55401,101706,99563,92062,4970,502,1699,104,226,2143,0.531,0500000US48209,Hays County,241067,92871,148196,137146,121568,9004,599,4822,144,1009,11050,0.593,0.062,0.118,6.2%,11.8%
0500000US48211,48211,48,211,"Hemphill County, Texas",3807,1086,2721,2693,2656,4,12,18,3,0,28,0.432,0500000US48211,Hemphill County,3382,1137,2245,2126,2090,4,18,10,0,4,119,0.504,0.072,0.167,7.2%,16.7%
0500000US48213,48213,48,213,"Henderson County, Texas",78532,8490,70042,69077,63494,4813,349,318,27,76,965,0.331,0500000US48213,Henderson County,82150,11242,70908,67725,61854,4705,414,510,31,211,3183,0.410,0.079,0.238,7.9%,23.8%
0500000US48215,48215,48,215,"Hidalgo County, Texas",774769,702206,72563,71373,60553,2777,524,7122,49,348,1190,0.172,0500000US48215,Hidalgo County,870781,800001,70780,67934,53338,3364,635,8604,78,1915,2846,0.152,-0.020,-0.118,-2.0%,-11.8%
0500000US48217,48217,48,217,"Hill County, Texas",35089,6427,28662,28259,25836,2161,118,105,20,19,403,0.420,0500000US48217,Hill County,35874,7884,27990,26605,24123,2055,137,188,15,87,1385,0.495,0.074,0.177,7.4%,17.7%
0500000US48219,48219,48,219,"Hockley County, Texas",22935,9993,12942,12781,11795,801,83,60,3,39,161,0.544,0500000US48219,Hockley County,21537,10624,10913,10511,9752,565,82,49,4,59,402,0.551,0.006,0.011,0.6%,1.1%
0500000US48221,48221,48,221,"Hood County, Texas",51182,5234,45948,45463,44588,225,288,296,32,34,485,0.230,0500000US48221,Hood County,61598,7958,53640,51351,49815,495,340,468,53,180,2289,0.328,0.097,0.422,9.7%,42.2%
0500000US48223,48223,48,223,"Hopkins County, Texas",35161,5368,29793,29315,26501,2448,162,172,14,18,478,0.404,0500000US48223,Hopkins County,36787,6484,30303,28913,25976,2373,198,277,4,85,1390,0.465,0.061,0.151,6.1%,15.1%
0500000US48225,48225,48,225,"Houston County, Texas",23732,2364,21368,21136,14811,6129,75,95,1,25,232,0.534,0500000US48225,Houston County,22066,3071,18995,18418,12957,5163,94,138,8,58,577,0.580,0.047,0.087,4.7%,8.7%
0500000US48227,48227,48,227,"Howard County, Texas",35012,13255,21757,21445,18801,2079,220,256,13,76,312,0.565,0500000US48227,Howard County,34860,16174,18686,17869,15672,1520,211,386,12,68,817,0.580,0.015,0.027,1.5%,2.7%
0500000US48229,48229,48,229,"Hudspeth County, Texas",3476,2768,708,683,628,30,11,13,0,1,25,0.333,0500000US48229,Hudspeth County,3202,2036,1166,1123,1094,6,6,10,0,7,43,0.479,0.146,0.437,14.6%,43.7%
0500000US48231,48231,48,231,"Hunt County, Texas",86129,11751,74378,73054,64393,6976,600,897,130,58,1324,0.415,0500000US48231,Hunt County,99956,19673,80283,75563,65598,7812,722,979,151,301,4720,0.522,0.107,0.257,10.7%,25.7%
0500000US48233,48233,48,233,"Hutchinson County, Texas",22150,4386,17764,17411,16482,512,300,91,3,23,353,0.406,0500000US48233,Hutchinson County,20617,4961,15656,14631,13783,416,273,105,2,52,1025,0.492,0.086,0.212,8.6%,21.2%
0500000US48235,48235,48,235,"Irion County, Texas",1599,407,1192,1174,1153,11,7,3,0,0,18,0.415,0500000US48235,Irion County,1513,349,1164,1129,1112,6,9,0,1,1,35,0.406,-0.009,-0.022,-0.9%,-2.2%
0500000US48237,48237,48,237,"Jack County, Texas",9044,1283,7761,7706,7289,340,38,30,3,6,55,0.329,0500000US48237,Jack County,8472,1521,6951,6742,6358,294,35,41,5,9,209,0.403,0.074,0.225,7.4%,22.5%
0500000US48239,48239,48,239,"Jackson County, Texas",14075,4079,9996,9891,8855,942,35,50,1,8,105,0.516,0500000US48239,Jackson County,14988,4829,10159,9748,8510,937,36,158,5,102,411,0.569,0.053,0.103,5.3%,10.3%
0500000US48241,48241,48,241,"Jasper County, Texas",35710,2017,33693,33271,26939,5931,168,200,12,21,422,0.400,0500000US48241,Jasper County,32980,2198,30782,29696,23795,5572,127,114,16,72,1086,0.445,0.045,0.114,4.5%,11.4%
0500000US48243,48243,48,243,"Jeff Davis County, Texas",2342,790,1552,1517,1490,10,8,7,1,1,35,0.481,0500000US48243,Jeff Davis County,1996,613,1383,1317,1282,0,6,14,0,15,66,0.492,0.011,0.022,1.1%,2.2%
0500000US48245,48245,48,245,"Jefferson County, Texas",252273,42899,209374,206594,112503,84500,747,8525,64,255,2780,0.659,0500000US48245,Jefferson County,256526,58915,197611,191401,96047,83856,622,9943,66,867,6210,0.698,0.039,0.060,3.9%,6.0%
0500000US48247,48247,48,247,"Jim Hogg County, Texas",5300,4907,393,380,334,18,14,14,0,0,13,0.139,0500000US48247,Jim Hogg County,4838,4281,557,473,414,5,15,26,5,8,84,0.209,0.071,0.508,7.1%,50.8%
0500000US48249,48249,48,249,"Jim Wells County, Texas",40838,32254,8584,8481,8062,156,97,134,4,28,103,0.337,0500000US48249,Jim Wells County,38891,30835,8056,7451,6963,180,58,140,15,95,605,0.339,0.002,0.005,0.2%,0.5%
0500000US48251,48251,48,251,"Johnson County, Texas",150934,27319,123615,121673,115545,3797,741,951,475,164,1942,0.380,0500000US48251,Johnson County,179927,42613,137314,129779,119226,6446,840,1726,929,612,7535,0.502,0.121,0.319,12.1%,31.9%
0500000US48253,48253,48,253,"Jones County, Texas",20202,5009,15193,15007,12549,2292,62,76,1,27,186,0.540,0500000US48253,Jones County,19663,5504,14159,13685,11485,1978,66,111,4,41,474,0.570,0.030,0.056,3.0%,5.6%
0500000US48255,48255,48,255,"Karnes County, Texas",14824,7376,7448,7389,5956,1351,37,25,2,18,59,0.583,0500000US48255,Karnes County,14710,7734,6976,6737,5388,1116,26,145,1,61,239,0.583,0.001,0.001,0.1%,0.1%
0500000US48257,48257,48,257,"Kaufman County, Texas",103350,17548,85802,84420,72328,10571,551,869,32,69,1382,0.471,0500000US48257,Kaufman County,145310,36165,109145,103402,78626,21541,623,2107,70,435,5743,0.622,0.151,0.320,15.1%,32.0%
0500000US48259,48259,48,259,"Kendall County, Texas",33410,6829,26581,26254,25746,138,129,202,13,26,327,0.364,0500000US48259,Kendall County,44279,10029,34250,32813,31767,315,138,355,36,202,1437,0.433,0.069,0.188,6.9%,18.8%
0500000US48261,48261,48,261,"Kenedy County, Texas",416,319,97,96,86,1,6,1,0,2,1,0.369,0500000US48261,Kenedy County,350,261,89,83,73,0,7,0,1,2,6,0.400,0.031,0.083,3.1%,8.3%
0500000US48263,48263,48,263,"Kent County, Texas",808,120,688,680,669,6,5,0,0,0,8,0.292,0500000US48263,Kent County,753,81,672,665,657,2,3,0,0,3,7,0.227,-0.065,-0.223,-6.5%,-22.3%
0500000US48265,48265,48,265,"Kerr County, Texas",49625,11895,37730,37215,35851,739,207,361,19,38,515,0.420,0500000US48265,Kerr County,52598,13598,39000,37439,35791,690,156,576,39,187,1561,0.469,0.049,0.116,4.9%,11.6%
0500000US48267,48267,48,267,"Kimble County, Texas",4607,1077,3530,3511,3450,16,17,19,3,6,19,0.384,0500000US48267,Kimble County,4286,986,3300,3202,3136,8,14,33,3,8,98,0.411,0.027,0.069,2.7%,6.9%
0500000US48269,48269,48,269,"King County, Texas",286,39,247,243,242,0,1,0,0,0,4,0.265,0500000US48269,King County,265,25,240,234,230,0,0,0,4,0,6,0.237,-0.028,-0.106,-2.8%,-10.6%
0500000US48271,48271,48,271,"Kinney County, Texas",3598,2004,1594,1570,1496,39,19,10,0,6,24,0.517,0500000US48271,Kinney County,3129,1470,1659,1573,1489,36,21,10,2,15,86,0.552,0.035,0.068,3.5%,6.8%
0500000US48273,48273,48,273,"Kleberg County, Texas",32061,22495,9566,9369,7479,1070,51,715,26,28,197,0.452,0500000US48273,Kleberg County,31040,21920,9120,8688,6728,995,83,784,1,97,432,0.452,0.001,0.002,0.1%,0.2%
0500000US48275,48275,48,275,"Knox County, Texas",3719,1101,2618,2582,2347,209,14,7,1,4,36,0.511,0500000US48275,Knox County,3353,1130,2223,2121,1935,146,8,24,3,5,102,0.551,0.040,0.078,4.0%,7.8%
0500000US48277,48277,48,277,"Lamar County, Texas",49793,3223,46570,45447,37891,6628,592,304,5,27,1123,0.398,0500000US48277,Lamar County,50088,4412,45676,43101,35354,6378,751,474,25,119,2575,0.475,0.077,0.192,7.7%,19.2%
0500000US48279,48279,48,279,"Lamb County, Texas",13977,7231,6746,6651,6020,555,39,17,4,16,95,0.545,0500000US48279,Lamb County,13045,7449,5596,5421,4981,392,15,4,5,24,175,0.527,-0.018,-0.033,-1.8%,-3.3%
0500000US48281,48281,48,281,"Lampasas County, Texas",19677,3443,16234,15794,14836,581,127,184,35,31,440,0.399,0500000US48281,Lampasas County,21627,4179,17448,16375,15132,700,115,242,86,100,1073,0.469,0.070,0.175,7.0%,17.5%
0500000US48283,48283,48,283,"La Salle County, Texas",6886,5920,966,948,894,18,25,6,0,5,18,0.244,0500000US48283,La Salle County,6664,4908,1756,1700,1467,221,3,4,0,5,56,0.408,0.164,0.672,16.4%,67.2%
0500000US48285,48285,48,285,"Lavaca County, Texas",19263,3077,16186,16050,14674,1255,30,56,17,18,136,0.390,0500000US48285,Lavaca County,20337,3936,16401,15877,14564,1173,30,74,5,31,524,0.446,0.056,0.143,5.6%,14.3%
0500000US48287,48287,48,287,"Lee County, Texas",16612,3724,12888,12690,10798,1772,44,52,17,7,198,0.516,0500000US48287,Lee County,17478,4479,12999,12385,10612,1631,47,57,1,37,614,0.556,0.040,0.078,4.0%,7.8%
0500000US48289,48289,48,289,"Leon County, Texas",16801,2260,14541,14394,13078,1181,57,75,2,1,147,0.371,0500000US48289,Leon County,15719,2446,13273,12798,11659,921,54,111,6,47,475,0.421,0.050,0.136,5.0%,13.6%
0500000US48291,48291,48,291,"Liberty County, Texas",75643,13602,62041,61164,52321,8074,289,337,23,120,877,0.478,0500000US48291,Liberty County,91628,30797,60831,58166,50044,7024,291,466,12,329,2665,0.582,0.104,0.218,10.4%,21.8%
0500000US48293,48293,48,293,"Limestone County, Texas",23384,4465,18919,18649,14433,4041,68,84,1,22,270,0.553,0500000US48293,Limestone County,22146,5013,17133,16476,12530,3636,72,160,18,60,657,0.601,0.048,0.087,4.8%,8.7%
0500000US48295,48295,48,295,"Lipscomb County, Texas",3302,1007,2295,2254,2213,7,22,10,0,2,41,0.458,0500000US48295,Lipscomb County,3059,1123,1936,1825,1786,4,29,2,0,4,111,0.523,0.065,0.143,6.5%,14.3%
0500000US48297,48297,48,297,"Live Oak County, Texas",11531,4060,7471,7388,6805,453,62,56,3,9,83,0.526,0500000US48297,Live Oak County,11335,4790,6545,6305,5968,205,49,35,3,45,240,0.543,0.017,0.033,1.7%,3.3%
0500000US48299,48299,48,299,"Llano County, Texas",19301,1542,17759,17584,17303,102,87,76,5,11,175,0.190,0500000US48299,Llano County,21243,2508,18735,17928,17530,97,115,121,4,61,807,0.304,0.114,0.599,11.4%,59.9%
0500000US48301,48301,48,301,"Loving County, Texas",82,18,64,64,60,0,4,0,0,0,0,0.414,0500000US48301,Loving County,64,1,63,58,56,0,1,0,0,1,5,0.228,-0.187,-0.450,-18.7%,-45.0%
0500000US48303,48303,48,303,"Lubbock County, Texas",278831,88924,189907,186893,159815,19957,1026,5650,161,284,3014,0.564,0500000US48303,Lubbock County,310639,109170,201469,192731,154994,25663,1436,9490,180,968,8738,0.619,0.055,0.097,5.5%,9.7%
0500000US48305,48305,48,305,"Lynn County, Texas",5915,2743,3172,3138,2984,113,28,8,0,5,34,0.530,0500000US48305,Lynn County,5596,2352,3244,3106,2960,105,15,10,4,12,138,0.543,0.013,0.024,1.3%,2.4%
0500000US48307,48307,48,307,"McCulloch County, Texas",8283,2476,5807,5762,5568,133,23,28,1,9,45,0.458,0500000US48307,McCulloch County,7630,2369,5261,5054,4904,92,7,39,0,12,207,0.490,0.031,0.068,3.1%,6.8%
0500000US48309,48309,48,309,"McLennan County, Texas",234906,55471,179435,176338,138295,33892,704,3128,84,235,3097,0.576,0500000US48309,McLennan County,260579,68587,191992,182808,139693,36130,901,4873,146,1065,9184,0.622,0.046,0.080,4.6%,8.0%
0500000US48311,48311,48,311,"McMullen County, Texas",707,261,446,443,432,8,0,3,0,0,3,0.490,0500000US48311,McMullen County,600,224,376,363,353,1,1,3,5,0,13,0.514,0.024,0.048,2.4%,4.8%
0500000US48313,48313,48,313,"Madison County, Texas",13664,2688,10976,10831,8030,2687,32,77,1,4,145,0.577,0500000US48313,Madison County,13455,3415,10040,9731,6984,2587,48,101,0,11,309,0.629,0.051,0.089,5.1%,8.9%
0500000US48315,48315,48,315,"Marion County, Texas",10546,328,10218,10016,7564,2319,72,50,3,8,202,0.436,0500000US48315,Marion County,9725,389,9336,8877,6869,1846,69,48,0,45,459,0.461,0.025,0.058,2.5%,5.8%
0500000US48317,48317,48,317,"Martin County, Texas",4799,2086,2713,2681,2578,67,15,11,3,7,32,0.522,0500000US48317,Martin County,5237,2255,2982,2912,2780,81,22,9,1,19,70,0.532,0.010,0.019,1.0%,1.9%
0500000US48319,48319,48,319,"Mason County, Texas",4012,864,3148,3128,3092,14,11,7,0,4,20,0.360,0500000US48319,Mason County,3953,883,3070,2970,2948,4,0,2,0,16,100,0.393,0.034,0.094,3.4%,9.4%
0500000US48321,48321,48,321,"Matagorda County, Texas",36702,14074,22628,22297,17400,4060,104,693,7,33,331,0.616,0500000US48321,Matagorda County,36255,15455,20800,19998,15355,3734,99,700,7,103,802,0.627,0.012,0.019,1.2%,1.9%
0500000US48323,48323,48,323,"Maverick County, Texas",54258,51914,2344,2290,1552,75,506,140,2,15,54,0.084,0500000US48323,Maverick County,57887,54936,2951,2834,1574,129,835,182,4,110,117,0.098,0.015,0.177,1.5%,17.7%
0500000US48325,48325,48,325,"Medina County, Texas",46006,22871,23135,22791,21408,913,146,272,24,28,344,0.536,0500000US48325,Medina County,50748,25455,25293,24175,22324,1252,158,215,38,188,1118,0.554,0.018,0.033,1.8%,3.3%
0500000US48327,48327,48,327,"Menard County, Texas",2242,790,1452,1446,1425,11,6,3,0,1,6,0.472,0500000US48327,Menard County,1962,662,1300,1266,1231,12,7,5,3,8,34,0.492,0.020,0.043,2.0%,4.3%
0500000US48329,48329,48,329,"Midland County, Texas",136872,51600,85272,83941,72822,8675,552,1639,42,211,1331,0.571,0500000US48329,Midland County,169983,73331,96652,92302,76487,10465,686,3891,152,621,4350,0.606,0.036,0.063,3.6%,6.3%
0500000US48331,48331,48,331,"Milam County, Texas",24757,5780,18977,18777,16216,2380,76,95,0,10,200,0.507,0500000US48331,Milam County,24754,6264,18490,17737,15367,2097,67,111,11,84,753,0.542,0.035,0.070,3.5%,7.0%
0500000US48333,48333,48,333,"Mills County, Texas",4936,818,4118,4076,4024,26,15,10,1,0,42,0.308,0500000US48333,Mills County,4456,728,3728,3543,3498,25,10,4,0,6,185,0.355,0.047,0.154,4.7%,15.4%
0500000US48335,48335,48,335,"Mitchell County, Texas",9403,3481,5922,5877,4753,1043,44,27,0,10,45,0.595,0500000US48335,Mitchell County,8990,3454,5536,5353,4328,925,34,54,1,11,183,0.610,0.014,0.024,1.4%,2.4%
0500000US48337,48337,48,337,"Montague County, Texas",19719,1930,17789,17587,17347,38,137,59,3,3,202,0.216,0500000US48337,Montague County,19965,2361,17604,16692,16342,73,155,84,4,34,912,0.314,0.097,0.451,9.7%,45.1%
0500000US48339,48339,48,339,"Montgomery County, Texas",455746,94698,361048,355178,324611,18537,1807,9347,241,635,5870,0.447,0500000US48339,Montgomery County,620443,164089,456354,432056,371403,34177,1884,21436,634,2522,24298,0.566,0.119,0.265,11.9%,26.5%
0500000US48341,48341,48,341,"Moore County, Texas",21904,11542,10362,10166,8370,287,107,1323,18,61,196,0.572,0500000US48341,Moore County,21358,12647,8711,8316,6499,654,97,982,1,83,395,0.553,-0.019,-0.033,-1.9%,-3.3%
0500000US48343,48343,48,343,"Morris County, Texas",12934,1003,11931,11723,8636,2952,82,43,3,7,208,0.496,0500000US48343,Morris County,11973,1182,10791,10308,7716,2448,70,35,9,30,483,0.531,0.036,0.072,3.6%,7.2%
0500000US48345,48345,48,345,"Motley County, Texas",1210,163,1047,1045,1013,24,8,0,0,0,2,0.281,0500000US48345,Motley County,1063,153,910,867,858,7,0,0,0,2,43,0.326,0.046,0.162,4.6%,16.2%
0500000US48347,48347,48,347,"Nacogdoches County, Texas",64524,11356,53168,52346,39699,11573,230,775,15,54,822,0.558,0500000US48347,Nacogdoches County,64653,13597,51056,48876,37158,10567,191,760,10,190,2180,0.597,0.039,0.071,3.9%,7.1%
0500000US48349,48349,48,349,"Navarro County, Texas",47735,11345,36390,35891,28587,6490,155,239,380,40,499,0.566,0500000US48349,Navarro County,52624,16049,36575,34709,26996,6286,163,393,734,137,1866,0.628,0.062,0.109,6.2%,10.9%
0500000US48351,48351,48,351,"Newton County, Texas",14445,403,14042,13856,10825,2891,77,62,1,0,186,0.397,0500000US48351,Newton County,12217,344,11873,11434,9249,2075,59,24,0,27,439,0.396,-0.001,-0.004,-0.1%,-0.4%
0500000US48353,48353,48,353,"Nolan County, Texas",15216,5103,10113,9967,9191,666,44,58,0,8,146,0.521,0500000US48353,Nolan County,14738,5354,9384,8952,8138,625,53,103,2,31,432,0.560,0.040,0.076,4.0%,7.6%
0500000US48355,48355,48,355,"Nueces County, Texas",340223,206293,133930,131033,111870,12178,882,5495,209,399,2897,0.523,0500000US48355,Nueces County,353178,217052,136126,128980,106165,12651,907,7712,281,1264,7146,0.530,0.007,0.014,0.7%,1.4%
0500000US48357,48357,48,357,"Ochiltree County, Texas",10223,4982,5241,5174,5062,19,66,24,3,0,67,0.517,0500000US48357,Ochiltree County,10015,5470,4545,4341,4245,14,31,28,2,21,204,0.522,0.004,0.008,0.4%,0.8%
0500000US48359,48359,48,359,"Oldham County, Texas",2052,243,1809,1787,1699,60,11,17,0,0,22,0.299,0500000US48359,Oldham County,1758,313,1445,1374,1325,33,6,10,0,0,71,0.398,0.099,0.330,9.9%,33.0%
0500000US48361,48361,48,361,"Orange County, Texas",81837,4766,77071,76065,67895,6922,340,797,38,73,1006,0.301,0500000US48361,Orange County,84808,7265,77543,74576,64935,7981,343,1108,13,196,2967,0.396,0.095,0.317,9.5%,31.7%
0500000US48363,48363,48,363,"Palo Pinto County, Texas",28111,4985,23126,22846,21958,597,135,132,11,13,280,0.358,0500000US48363,Palo Pinto County,28409,5614,22795,21771,20778,552,149,211,12,69,1024,0.424,0.066,0.186,6.6%,18.6%
0500000US48365,48365,48,365,"Panola County, Texas",23796,1970,21826,21554,17521,3850,84,72,3,24,272,0.425,0500000US48365,Panola County,22491,2190,20301,19570,16098,3244,96,99,7,26,731,0.456,0.032,0.075,3.2%,7.5%
0500000US48367,48367,48,367,"Parker County, Texas",116927,12410,104517,103038,99698,1842,768,631,35,64,1479,0.261,0500000US48367,Parker County,148222,19819,128403,121818,117747,1636,878,990,97,470,6585,0.349,0.088,0.335,8.8%,33.5%
0500000US48369,48369,48,369,"Parmer County, Texas",10269,6164,4105,4079,3943,91,17,18,8,2,26,0.492,0500000US48369,Parmer County,9869,6504,3365,3304,3187,53,11,14,0,39,61,0.461,-0.031,-0.063,-3.1%,-6.3%
0500000US48371,48371,48,371,"Pecos County, Texas",15507,10430,5077,5007,4326,528,57,74,5,17,70,0.469,0500000US48371,Pecos County,15193,10845,4348,4189,3473,505,33,143,0,35,159,0.437,-0.032,-0.068,-3.2%,-6.8%
0500000US48373,48373,48,373,"Polk County, Texas",45413,5959,39454,38962,32830,5153,778,180,7,14,492,0.447,0500000US48373,Polk County,50123,7345,42778,41066,34808,4869,914,340,0,135,1712,0.485,0.038,0.086,3.8%,8.6%
0500000US48375,48375,48,375,"Potter County, Texas",121073,42692,78381,76620,59322,11823,602,4675,43,155,1761,0.624,0500000US48375,Potter County,118525,45193,73332,69457,50153,11999,636,6036,20,613,3875,0.662,0.037,0.060,3.7%,6.0%
0500000US48377,48377,48,377,"Presidio County, Texas",7818,6521,1297,1263,1136,27,22,75,0,3,34,0.283,0500000US48377,Presidio County,6131,4991,1140,1096,961,25,16,85,0,9,44,0.312,0.029,0.104,2.9%,10.4%
0500000US48379,48379,48,379,"Rains County, Texas",10914,839,10075,9953,9553,249,95,55,1,0,122,0.227,0500000US48379,Rains County,12164,1109,11055,10568,10130,264,85,55,1,33,487,0.296,0.069,0.303,6.9%,30.3%
0500000US48381,48381,48,381,"Randall County, Texas",120725,19775,100950,99395,94361,2701,586,1625,29,93,1555,0.361,0500000US48381,Randall County,140753,31583,109170,103888,95457,4567,794,2604,54,412,5282,0.487,0.125,0.347,12.5%,34.7%
0500000US48383,48383,48,383,"Reagan County, Texas",3367,2051,1316,1293,1219,65,7,1,0,1,23,0.497,0500000US48383,Reagan County,3385,2283,1102,1039,968,33,12,19,1,6,63,0.463,-0.035,-0.070,-3.5%,-7.0%
0500000US48385,48385,48,385,"Real County, Texas",3309,814,2495,2456,2398,20,23,2,12,1,39,0.414,0500000US48385,Real County,2758,692,2066,1987,1940,22,8,12,3,2,79,0.441,0.027,0.066,2.7%,6.6%
0500000US48387,48387,48,387,"Red River County, Texas",12860,849,12011,11832,9503,2211,92,23,0,3,179,0.420,0500000US48387,Red River County,11587,766,10821,10403,8499,1738,102,51,0,13,418,0.434,0.014,0.033,1.4%,3.3%
0500000US48389,48389,48,389,"Reeves County, Texas",13783,10233,3550,3523,2690,672,21,118,2,20,27,0.408,0500000US48389,Reeves County,14748,12510,2238,2155,1697,224,27,165,3,39,83,0.267,-0.141,-0.346,-14.1%,-34.6%
0500000US48391,48391,48,391,"Refugio County, Texas",7383,3487,3896,3843,3337,445,25,27,0,9,53,0.569,0500000US48391,Refugio County,6741,3306,3435,3321,2864,400,18,27,0,12,114,0.575,0.006,0.011,0.6%,1.1%
0500000US48393,48393,48,393,"Roberts County, Texas",929,74,855,846,841,0,3,2,0,0,9,0.174,0500000US48393,Roberts County,827,50,777,722,717,2,2,0,0,1,55,0.240,0.066,0.380,6.6%,38.0%
0500000US48395,48395,48,395,"Robertson County, Texas",16622,2990,13632,13482,9821,3509,47,96,0,9,150,0.574,0500000US48395,Robertson County,16757,3528,13229,12791,9505,3095,29,104,21,37,438,0.599,0.025,0.044,2.5%,4.4%
0500000US48397,48397,48,397,"Rockwall County, Texas",78337,12470,65867,64801,58046,4397,345,1850,47,116,1066,0.422,0500000US48397,Rockwall County,107819,20560,87259,82581,70198,8179,479,3306,75,344,4678,0.531,0.109,0.260,10.9%,26.0%
0500000US48399,48399,48,399,"Runnels County, Texas",10501,3361,7140,7083,6841,165,43,19,0,15,57,0.473,0500000US48399,Runnels County,9900,3354,6546,6278,6062,132,39,24,6,15,268,0.509,0.036,0.077,3.6%,7.7%
0500000US48401,48401,48,401,"Rusk County, Texas",53330,7609,45721,45062,35237,9359,199,203,14,50,659,0.512,0500000US48401,Rusk County,52214,9579,42635,40868,32022,8240,195,231,18,162,1767,0.564,0.052,0.102,5.2%,10.2%
0500000US48403,48403,48,403,"Sabine County, Texas",10834,344,10490,10355,9484,778,54,33,0,6,135,0.227,0500000US48403,Sabine County,9894,393,9501,9179,8307,734,51,52,0,35,322,0.287,0.060,0.262,6.0%,26.2%
0500000US48405,48405,48,405,"San Augustine County, Texas",8865,532,8333,8244,6183,2013,16,22,0,10,89,0.458,0500000US48405,San Augustine County,7918,639,7279,7093,5270,1768,19,36,0,0,186,0.500,0.042,0.091,4.2%,9.1%
0500000US48407,48407,48,407,"San Jacinto County, Texas",26384,2880,23504,23127,20204,2662,120,120,9,12,377,0.391,0500000US48407,San Jacinto County,27402,4822,22580,21551,19170,2083,123,86,15,74,1029,0.472,0.081,0.207,8.1%,20.7%
0500000US48409,48409,48,409,"San Patricio County, Texas",64804,35248,29556,29006,27330,902,169,506,46,53,550,0.526,0500000US48409,San Patricio County,68755,38220,30535,28943,26613,994,198,845,66,227,1592,0.540,0.014,0.027,1.4%,2.7%
0500000US48411,48411,48,411,"San Saba County, Texas",6131,1715,4416,4371,4135,194,28,13,0,1,45,0.466,0500000US48411,San Saba County,5730,1749,3981,3852,3690,106,29,16,1,10,129,0.491,0.025,0.055,2.5%,5.5%
0500000US48413,48413,48,413,"Schleicher County, Texas",3461,1536,1925,1909,1872,32,1,4,0,0,16,0.510,0500000US48413,Schleicher County,2451,1275,1176,1140,1102,15,4,7,2,10,36,0.527,0.017,0.033,1.7%,3.3%
0500000US48415,48415,48,415,"Scurry County, Texas",16921,6149,10772,10646,9773,764,47,48,2,12,126,0.532,0500000US48415,Scurry County,16932,7139,9793,9410,8637,599,60,82,5,27,383,0.560,0.028,0.053,2.8%,5.3%
0500000US48417,48417,48,417,"Shackelford County, Texas",3378,340,3038,2995,2961,14,8,9,1,2,43,0.221,0500000US48417,Shackelford County,3105,363,2742,2654,2612,20,6,14,0,2,88,0.278,0.056,0.255,5.6%,25.5%
0500000US48419,48419,48,419,"Shelby County, Texas",25448,4164,21284,21103,16535,4414,61,76,0,17,181,0.521,0500000US48419,Shelby County,24022,4685,19337,18698,14416,3805,50,364,14,49,639,0.576,0.055,0.105,5.5%,10.5%
0500000US48421,48421,48,421,"Sherman County, Texas",3034,1227,1807,1792,1762,12,11,6,0,1,15,0.499,0500000US48421,Sherman County,2782,1315,1467,1385,1362,10,5,2,0,6,82,0.536,0.037,0.074,3.7%,7.4%
0500000US48423,48423,48,423,"Smith County, Texas",209714,36088,173626,171013,130246,37195,734,2550,63,225,2613,0.553,0500000US48423,Smith County,233479,47281,186198,178102,134452,38003,746,4129,77,695,8096,0.599,0.046,0.084,4.6%,8.4%
0500000US48425,48425,48,425,"Somervell County, Texas",8490,1626,6864,6759,6595,54,45,40,1,24,105,0.360,0500000US48425,Somervell County,9205,1687,7518,7187,7011,39,49,55,0,33,331,0.385,0.025,0.070,2.5%,7.0%
0500000US48427,48427,48,427,"Starr County, Texas",60968,58337,2631,2605,2449,15,17,119,0,5,26,0.083,0500000US48427,Starr County,65920,64393,1527,1408,1171,31,8,100,0,98,119,0.045,-0.037,-0.451,-3.7%,-45.1%
0500000US48429,48429,48,429,"Stephens County, Texas",9630,2011,7619,7559,7289,195,43,31,1,0,60,0.383,0500000US48429,Stephens County,9101,2204,6897,6617,6256,237,36,60,1,27,280,0.467,0.084,0.220,8.4%,22.0%
0500000US48431,48431,48,431,"Sterling County, Texas",1143,365,778,761,733,13,13,0,0,2,17,0.486,0500000US48431,Sterling County,1372,449,923,879,867,3,4,1,2,2,44,0.493,0.006,0.013,0.6%,1.3%
0500000US48433,48433,48,433,"Stonewall County, Texas",1490,209,1281,1262,1206,38,4,14,0,0,19,0.324,0500000US48433,Stonewall County,1245,226,1019,986,958,18,3,5,0,2,33,0.374,0.050,0.153,5.0%,15.3%
0500000US48435,48435,48,435,"Sutton County, Texas",4128,2459,1669,1659,1639,6,2,5,0,7,10,0.487,0500000US48435,Sutton County,3372,2093,1279,1231,1200,6,5,6,0,14,48,0.488,0.000,0.001,0.0%,0.1%
0500000US48437,48437,48,437,"Swisher County, Texas",7854,3149,4705,4629,4025,552,37,5,4,6,76,0.572,0500000US48437,Swisher County,6971,3147,3824,3662,3219,407,18,10,0,8,162,0.579,0.007,0.013,0.7%,1.3%
0500000US48439,48439,48,439,"Tarrant County, Texas",1809034,482977,1326057,1295501,937135,262522,7037,83378,2938,2491,30556,0.637,0500000US48439,Tarrant County,2110640,620907,1489733,1410813,904884,358645,7033,127783,4147,8321,78920,0.696,0.059,0.092,5.9%,9.2%
0500000US48441,48441,48,441,"Taylor County, Texas",131506,29074,102432,99991,88121,9122,532,1978,105,133,2441,0.497,0500000US48441,Taylor County,143208,34756,108452,102329,87316,10980,589,2815,161,468,6123,0.561,0.065,0.130,6.5%,13.0%
0500000US48443,48443,48,443,"Terrell County, Texas",984,467,517,512,495,6,7,4,0,0,5,0.522,0500000US48443,Terrell County,760,370,390,367,352,8,0,5,0,2,23,0.547,0.026,0.050,2.6%,5.0%
0500000US48445,48445,48,445,"Terry County, Texas",12651,6211,6440,6368,5747,565,28,23,0,5,72,0.551,0500000US48445,Terry County,11831,6569,5262,5078,4599,389,29,37,0,24,184,0.539,-0.011,-0.021,-1.1%,-2.1%
0500000US48447,48447,48,447,"Throckmorton County, Texas",1641,152,1489,1480,1453,9,11,7,0,0,9,0.207,0500000US48447,Throckmorton County,1440,145,1295,1255,1248,1,3,3,0,0,40,0.238,0.031,0.148,3.1%,14.8%
0500000US48449,48449,48,449,"Titus County, Texas",32334,12799,19535,19290,15904,3000,125,229,9,23,245,0.593,0500000US48449,Titus County,31247,13680,17567,16733,13410,2884,101,262,3,73,834,0.615,0.022,0.037,2.2%,3.7%
0500000US48451,48451,48,451,"Tom Green County, Texas",110224,39315,70909,69455,63799,3997,406,1046,78,129,1454,0.536,0500000US48451,Tom Green County,120003,47066,72937,68982,62390,4010,366,1704,143,369,3955,0.573,0.037,0.070,3.7%,7.0%
0500000US48453,48453,48,453,"Travis County, Texas",1024266,342766,681500,663817,517644,82805,2611,58404,540,1813,17683,0.623,0500000US48453,Travis County,1290188,421110,869078,818803,612824,96270,2762,99660,774,6513,50275,0.655,0.032,0.052,3.2%,5.2%
0500000US48455,48455,48,455,"Trinity County, Texas",14585,1117,13468,13302,11819,1377,57,36,0,13,166,0.328,0500000US48455,Trinity County,13602,1314,12288,11715,10533,1086,29,30,4,33,573,0.383,0.054,0.166,5.4%,16.6%
0500000US48457,48457,48,457,"Tyler County, Texas",21766,1487,20279,20061,17507,2376,104,49,6,19,218,0.336,0500000US48457,Tyler County,19798,1520,18278,17600,15302,2040,111,97,3,47,678,0.385,0.049,0.144,4.9%,14.4%
0500000US48459,48459,48,459,"Upshur County, Texas",39309,2613,36696,36035,32257,3388,206,146,3,35,661,0.314,0500000US48459,Upshur County,40892,3986,36906,34792,31287,2908,261,177,9,150,2114,0.397,0.083,0.264,8.3%,26.4%
0500000US48461,48461,48,461,"Upton County, Texas",3355,1644,1711,1692,1611,49,28,0,0,4,19,0.529,0500000US48461,Upton County,3308,1797,1511,1395,1318,59,11,4,0,3,116,0.545,0.016,0.029,1.6%,2.9%
0500000US48463,48463,48,463,"Uvalde County, Texas",26405,18299,8106,7995,7666,110,62,116,6,35,111,0.435,0500000US48463,Uvalde County,24564,17317,7247,6975,6613,107,25,158,6,66,272,0.430,-0.005,-0.012,-0.5%,-1.2%
0500000US48465,48465,48,465,"Val Verde County, Texas",48879,39199,9680,9470,8548,563,86,207,37,29,210,0.326,0500000US48465,Val Verde County,47586,38207,9379,8902,7836,538,57,351,35,85,477,0.328,0.002,0.006,0.2%,0.6%
0500000US48467,48467,48,467,"Van Zandt County, Texas",52579,4847,47732,47076,45087,1403,371,168,32,15,656,0.255,0500000US48467,Van Zandt County,59541,7071,52470,50266,47986,1517,328,272,30,133,2204,0.334,0.079,0.310,7.9%,31.0%
0500000US48469,48469,48,469,"Victoria County, Texas",86793,38113,48680,47938,41564,5190,199,860,16,109,742,0.574,0500000US48469,Victoria County,91319,42931,48388,46432,39330,5230,214,1391,35,232,1956,0.590,0.015,0.027,1.5%,2.7%
0500000US48471,48471,48,471,"Walker County, Texas",67861,11389,56472,55663,39671,15098,186,617,19,72,809,0.580,0500000US48471,Walker County,76400,16578,59822,57939,39823,16382,251,1126,39,318,1883,0.634,0.054,0.093,5.4%,9.3%
0500000US48473,48473,48,473,"Waller County, Texas",43205,12536,30669,30214,19260,10537,141,213,9,54,455,0.657,0500000US48473,Waller County,56794,18486,38308,36917,23494,12104,210,785,10,314,1391,0.677,0.019,0.029,1.9%,2.9%
0500000US48475,48475,48,475,"Ward County, Texas",10658,5074,5584,5484,4922,474,48,31,0,9,100,0.558,0500000US48475,Ward County,11644,6325,5319,5055,4506,415,41,69,2,22,264,0.553,-0.005,-0.008,-0.5%,-0.8%
0500000US48477,48477,48,477,"Washington County, Texas",33718,4641,29077,28789,22394,5861,61,432,7,34,288,0.509,0500000US48477,Washington County,35805,6425,29380,28354,22023,5555,75,547,14,140,1026,0.564,0.055,0.108,5.5%,10.8%
0500000US48479,48479,48,479,"Webb County, Texas",250304,239653,10651,10388,8345,487,95,1320,11,130,263,0.082,0500000US48479,Webb County,267114,254354,12760,12201,9495,788,135,1300,25,458,559,0.092,0.010,0.119,1.0%,11.9%
0500000US48481,48481,48,481,"Wharton County, Texas",41280,15445,25835,25593,19681,5668,62,154,2,26,242,0.614,0500000US48481,Wharton County,41570,16967,24603,23936,18130,5469,69,164,0,104,667,0.626,0.012,0.019,1.2%,1.9%
0500000US48483,48483,48,483,"Wheeler County, Texas",5410,1344,4066,4005,3847,112,20,23,0,3,61,0.432,0500000US48483,Wheeler County,4990,1227,3763,3621,3469,81,33,24,2,12,142,0.455,0.023,0.053,2.3%,5.3%
0500000US48485,48485,48,485,"Wichita County, Texas",131500,21859,109641,107190,90001,13322,1087,2586,85,109,2451,0.493,0500000US48485,Wichita County,129350,25803,103547,97328,79694,13379,992,2647,140,476,6219,0.567,0.074,0.151,7.4%,15.1%
0500000US48487,48487,48,487,"Wilbarger County, Texas",13535,3508,10027,9858,8585,1049,115,97,6,6,169,0.524,0500000US48487,Wilbarger County,12887,3734,9153,8719,7012,1013,96,566,0,32,434,0.611,0.086,0.165,8.6%,16.5%
0500000US48489,48489,48,489,"Willacy County, Texas",22134,19297,2837,2790,2235,389,22,134,1,9,47,0.229,0500000US48489,Willacy County,20164,17611,2553,2493,1805,445,47,160,2,34,60,0.229,-0.001,-0.003,-0.1%,-0.3%
0500000US48491,48491,48,491,"Williamson County, Texas",422679,98034,324645,316664,269481,24744,1340,20084,354,661,7981,0.534,0500000US48491,Williamson County,609017,147088,461929,434324,336410,38557,1659,53982,592,3124,27605,0.623,0.089,0.167,8.9%,16.7%
0500000US48493,48493,48,493,"Wilson County, Texas",42918,16412,26506,26132,25186,644,125,143,9,25,374,0.509,0500000US48493,Wilson County,49753,19232,30521,29158,27877,693,148,229,24,187,1363,0.536,0.027,0.052,2.7%,5.2%
0500000US48495,48495,48,495,"Winkler County, Texas",7110,3824,3286,3241,3024,129,29,16,0,43,45,0.529,0500000US48495,Winkler County,7791,4732,3059,2965,2702,139,38,77,0,9,94,0.510,-0.019,-0.036,-1.9%,-3.6%
0500000US48497,48497,48,497,"Wise County, Texas",59127,10112,49015,48320,47122,573,341,234,15,35,695,0.335,0500000US48497,Wise County,68632,13694,54938,52182,50495,657,474,372,12,172,2756,0.417,0.082,0.244,8.2%,24.4%
0500000US48499,48499,48,499,"Wood County, Texas",41964,3551,38413,37953,35628,1951,198,156,12,8,460,0.270,0500000US48499,Wood County,44843,4894,39949,38160,35906,1658,227,230,1,138,1789,0.344,0.074,0.275,7.4%,27.5%
0500000US48501,48501,48,501,"Yoakum County, Texas",7879,4622,3257,3207,3090,55,30,26,1,5,50,0.502,0500000US48501,Yoakum County,7694,4968,2726,2626,2488,55,22,46,0,15,100,0.478,-0.024,-0.047,-2.4%,-4.7%
0500000US48503,48503,48,503,"Young County, Texas",18550,3045,15505,15326,14959,220,83,55,5,4,179,0.322,0500000US48503,Young County,17867,3508,14359,13786,13409,174,79,86,0,38,573,0.397,0.075,0.231,7.5%,23.1%
0500000US48505,48505,48,505,"Zapata County, Texas",14018,13084,934,922,861,11,16,28,0,6,12,0.125,0500000US48505,Zapata County,13889,12999,890,844,796,9,7,16,0,16,46,0.121,-0.004,-0.034,-0.4%,-3.4%
0500000US48507,48507,48,507,"Zavala County, Texas",11677,10961,716,700,647,35,9,3,3,3,16,0.116,0500000US48507,Zavala County,9670,8944,726,683,572,67,21,19,1,3,43,0.141,0.025,0.217,2.5%,21.7%
0500000US49001,49001,49,1,"Beaver County, Utah",6629,716,5913,5859,5700,14,50,70,17,8,54,0.249,0500000US49001,Beaver County,7072,1066,6006,5871,5717,23,70,32,21,8,135,0.323,0.075,0.300,7.5%,30.0%
0500000US49003,49003,49,3,"Box Elder County, Utah",49975,4152,45823,45129,44109,139,329,430,78,44,694,0.214,0500000US49003,Box Elder County,57666,5537,52129,50543,49361,161,383,438,98,102,1586,0.257,0.043,0.203,4.3%,20.3%
0500000US49005,49005,49,5,"Cache County, Utah",112656,11216,101440,100018,96283,596,531,2096,411,101,1422,0.259,0500000US49005,Cache County,133154,15076,118078,114426,109376,1045,620,2303,660,422,3652,0.311,0.052,0.202,5.2%,20.2%
0500000US49007,49007,49,7,"Carbon County, Utah",21403,2659,18744,18436,18007,84,186,122,20,17,308,0.276,0500000US49007,Carbon County,20412,2677,17735,17044,16645,50,199,63,29,58,691,0.317,0.040,0.145,4.0%,14.5%
0500000US49009,49009,49,9,"Daggett County, Utah",1059,33,1026,1018,1000,4,7,4,1,2,8,0.107,0500000US49009,Daggett County,935,29,906,887,881,1,0,1,2,2,19,0.111,0.004,0.033,0.4%,3.3%
0500000US49011,49011,49,11,"Davis County, Utah",306479,25753,280726,274912,263049,3435,1090,5245,1753,340,5814,0.255,0500000US49011,Davis County,362679,39295,323384,309285,292458,4008,1464,6907,3204,1244,14099,0.336,0.080,0.315,8.0%,31.5%
0500000US49013,49013,49,13,"Duchesne County, Utah",18607,1117,17490,17121,16211,31,771,45,45,18,369,0.235,0500000US49013,Duchesne County,19596,1285,18311,17778,16736,21,875,60,39,47,533,0.264,0.028,0.120,2.8%,12.0%
0500000US49015,49015,49,15,"Emery County, Utah",10976,654,10322,10250,10108,25,67,38,9,3,72,0.148,0500000US49015,Emery County,9825,705,9120,8927,8811,2,55,36,7,16,193,0.190,0.042,0.283,4.2%,28.3%
0500000US49017,49017,49,17,"Garfield County, Utah",5172,234,4938,4901,4740,13,75,61,10,2,37,0.158,0500000US49017,Garfield County,5083,384,4699,4581,4446,5,90,30,7,3,118,0.228,0.071,0.449,7.1%,44.9%
0500000US49019,49019,49,19,"Grand County, Utah",9225,881,8344,8225,7759,27,351,77,3,8,119,0.282,0500000US49019,Grand County,9669,1226,8443,8029,7481,65,330,80,11,62,414,0.382,0.100,0.356,10.0%,35.6%
0500000US49021,49021,49,21,"Iron County, Utah",46163,3563,42600,41856,40226,204,907,333,137,49,744,0.234,0500000US49021,Iron County,57289,5482,51807,49955,47620,375,948,621,237,154,1852,0.298,0.064,0.275,6.4%,27.5%
0500000US49023,49023,49,23,"Juab County, Utah",10246,379,9867,9769,9631,21,75,22,15,5,98,0.115,0500000US49023,Juab County,11786,574,11212,10964,10781,11,89,32,41,10,248,0.160,0.045,0.396,4.5%,39.6%
0500000US49025,49025,49,25,"Kane County, Utah",7125,263,6862,6792,6639,15,103,31,1,3,70,0.130,0500000US49025,Kane County,7667,322,7345,7148,6924,27,119,59,1,18,197,0.182,0.052,0.397,5.2%,39.7%
0500000US49027,49027,49,27,"Millard County, Utah",12503,1603,10900,10797,10589,10,100,76,15,7,103,0.266,0500000US49027,Millard County,12975,1774,11201,10932,10636,15,100,141,13,27,269,0.309,0.043,0.160,4.3%,16.0%
0500000US49029,49029,49,29,"Morgan County, Utah",9469,226,9243,9175,9098,15,14,33,10,5,68,0.076,0500000US49029,Morgan County,12295,338,11957,11671,11562,12,31,57,0,9,286,0.114,0.038,0.501,3.8%,50.1%
0500000US49031,49031,49,31,"Piute County, Utah",1556,109,1447,1434,1419,2,5,6,2,0,13,0.163,0500000US49031,Piute County,1438,124,1314,1281,1276,0,4,0,0,1,33,0.205,0.041,0.253,4.1%,25.3%
0500000US49033,49033,49,33,"Rich County, Utah",2264,96,2168,2152,2131,0,16,2,1,2,16,0.112,0500000US49033,Rich County,2510,97,2413,2348,2329,11,1,2,4,1,65,0.137,0.025,0.220,2.5%,22.0%
0500000US49035,49035,49,35,"Salt Lake County, Utah",1029655,176015,853640,833929,761885,14622,6565,33454,15443,1960,19711,0.421,0500000US49035,Salt Lake County,1185238,232088,953150,907067,800914,21976,7205,50241,21194,5537,46083,0.501,0.080,0.189,8.0%,18.9%
0500000US49037,49037,49,37,"San Juan County, Utah",14746,649,14097,13845,6474,21,7308,35,5,2,252,0.559,0500000US49037,San Juan County,14518,747,13771,13367,6038,32,7186,34,51,26,404,0.579,0.019,0.034,1.9%,3.4%
0500000US49039,49039,49,39,"Sanpete County, Utah",27822,2619,25203,24867,24109,209,241,145,132,31,336,0.240,0500000US49039,Sanpete County,28437,3043,25394,24651,23688,224,240,171,247,81,743,0.294,0.054,0.224,5.4%,22.4%
0500000US49041,49041,49,41,"Sevier County, Utah",20802,932,19870,19651,19325,34,197,58,36,1,219,0.135,0500000US49041,Sevier County,21522,1053,20469,19912,19396,65,313,40,49,49,557,0.185,0.050,0.369,5.0%,36.9%
0500000US49043,49043,49,43,"Summit County, Utah",36324,4190,32134,31742,31012,110,89,440,31,60,392,0.258,0500000US49043,Summit County,42357,4737,37620,36258,35108,163,67,723,42,155,1362,0.299,0.042,0.162,4.2%,16.2%
0500000US49045,49045,49,45,"Tooele County, Utah",58218,6661,51557,50618,49174,372,464,357,212,39,939,0.273,0500000US49045,Tooele County,72698,9522,63176,60510,58199,436,445,511,637,282,2666,0.340,0.067,0.247,6.7%,24.7%
0500000US49047,49047,49,47,"Uintah County, Utah",32588,2330,30258,29710,26999,96,2375,159,71,10,548,0.303,0500000US49047,Uintah County,35620,2834,32786,31463,28726,90,2277,157,97,116,1323,0.338,0.035,0.115,3.5%,11.5%
0500000US49049,49049,49,49,"Utah County, Utah",516564,55793,460771,450863,434708,2421,2374,6912,3817,631,9908,0.280,0500000US49049,Utah County,659399,88531,570868,544176,518460,4110,2533,10111,6541,2421,26692,0.362,0.082,0.294,8.2%,29.4%
0500000US49051,49051,49,51,"Wasatch County, Utah",23530,3184,20346,20125,19818,49,52,168,24,14,221,0.272,0500000US49051,Wasatch County,34788,5046,29742,28829,28168,141,67,347,41,65,913,0.323,0.050,0.185,5.0%,18.5%
0500000US49053,49053,49,53,"Washington County, Utah",138115,13486,124629,122443,118282,632,1460,954,1022,93,2186,0.257,0500000US49053,Washington County,180279,20482,159797,153981,147462,913,1566,1802,1607,631,5816,0.317,0.060,0.234,6.0%,23.4%
0500000US49055,49055,49,55,"Wayne County, Utah",2778,116,2662,2629,2596,2,8,19,4,0,33,0.125,0500000US49055,Wayne County,2486,96,2390,2311,2267,1,19,16,3,5,79,0.166,0.041,0.329,4.1%,32.9%
0500000US49057,49057,49,57,"Weber County, Utah",231236,38711,192525,188294,180638,2748,1271,2784,584,269,4231,0.361,0500000US49057,Weber County,262223,48742,213481,204057,193889,3209,1394,3603,948,1014,9424,0.417,0.056,0.155,5.6%,15.5%
0500000US50001,50001,50,1,"Addison County, Vermont",36821,685,36136,35568,34660,269,75,524,5,35,568,0.113,0500000US50001,Addison County,37363,1153,36210,34576,33440,342,80,594,10,110,1634,0.196,0.083,0.731,8.3%,73.1%
0500000US50003,50003,50,3,"Bennington County, Vermont",37125,525,36600,36176,35517,291,71,264,13,20,424,0.084,0500000US50003,Bennington County,37347,939,36408,34886,33897,405,63,397,5,119,1522,0.174,0.089,1.060,8.9%,106.0%
0500000US50005,50005,50,5,"Caledonia County, Vermont",31227,331,30896,30477,29909,150,127,251,1,39,419,0.082,0500000US50005,Caledonia County,30233,605,29628,28272,27465,214,94,363,17,119,1356,0.172,0.090,1.093,9.0%,109.3%
0500000US50007,50007,50,7,"Chittenden County, Vermont",156545,2856,153689,150973,142848,3172,372,4368,41,172,2716,0.166,0500000US50007,Chittenden County,168323,4751,163572,155942,142880,4757,291,7203,49,762,7630,0.274,0.108,0.655,10.8%,65.5%
0500000US50009,50009,50,9,"Essex County, Vermont",6306,59,6247,6169,6094,16,36,22,0,1,78,0.066,0500000US50009,Essex County,5920,67,5853,5599,5544,15,14,16,5,5,254,0.121,0.055,0.839,5.5%,83.9%
0500000US50011,50011,50,11,"Franklin County, Vermont",47746,571,47175,46223,45290,200,487,223,11,12,952,0.100,0500000US50011,Franklin County,49946,915,49031,46491,45239,321,483,312,16,120,2540,0.177,0.077,0.773,7.7%,77.3%
0500000US50013,50013,50,13,"Grand Isle County, Vermont",6970,80,6890,6715,6600,23,64,21,4,3,175,0.102,0500000US50013,Grand Isle County,7293,127,7166,6831,6697,49,39,30,0,16,335,0.154,0.052,0.505,5.2%,50.5%
0500000US50015,50015,50,15,"Lamoille County, Vermont",24475,322,24153,23814,23427,142,88,124,3,30,339,0.083,0500000US50015,Lamoille County,25945,651,25294,24153,23585,217,88,141,1,121,1141,0.171,0.088,1.051,8.8%,105.1%
0500000US50017,50017,50,17,"Orange County, Vermont",28936,282,28654,28248,27898,107,78,137,3,25,406,0.070,0500000US50017,Orange County,29277,477,28800,27400,26852,151,113,160,5,119,1400,0.156,0.086,1.227,8.6%,122.7%
0500000US50019,50019,50,19,"Orleans County, Vermont",27231,305,26926,26523,26139,152,116,90,9,17,403,0.078,0500000US50019,Orleans County,27393,462,26931,25762,25259,127,197,119,1,59,1169,0.148,0.069,0.887,6.9%,88.7%
0500000US50021,50021,50,21,"Rutland County, Vermont",61642,681,60961,60227,59369,315,135,370,9,29,734,0.072,0500000US50021,Rutland County,60572,1225,59347,56374,55092,493,146,458,14,171,2973,0.170,0.098,1.356,9.8%,135.6%
0500000US50023,50023,50,23,"Washington County, Vermont",59534,995,58539,57572,56473,411,126,495,11,56,967,0.100,0500000US50023,Washington County,59807,1569,58238,55425,53704,612,135,632,23,319,2813,0.191,0.091,0.914,9.1%,91.4%
0500000US50025,50025,50,25,"Windham County, Vermont",44513,820,43693,42934,41906,384,107,460,18,59,759,0.113,0500000US50025,Windham County,45905,1333,44572,42348,41010,495,99,493,8,243,2224,0.198,0.086,0.758,8.6%,75.8%
0500000US50027,50027,50,27,"Windsor County, Vermont",56670,696,55974,55122,54093,311,141,526,12,39,852,0.088,0500000US50027,Windsor County,57753,1230,56523,53965,52537,451,144,539,16,278,2558,0.170,0.082,0.922,8.2%,92.2%
0500000US51001,51001,51,1,"Accomack County, Virginia",33164,2850,30314,29871,20266,9253,97,177,34,44,443,0.541,0500000US51001,Accomack County,33413,3430,29983,28878,19825,8639,65,249,1,99,1105,0.569,0.028,0.052,2.8%,5.2%
0500000US51003,51003,51,3,"Albemarle County, Virginia",98970,5417,93553,91579,77130,9487,150,4597,42,173,1974,0.378,0500000US51003,Albemarle County,112395,8453,103942,99058,80335,9793,96,8186,44,604,4884,0.469,0.091,0.240,9.1%,24.0%
0500000US51005,51005,51,5,"Alleghany County, Virginia",16250,176,16074,15870,15040,751,25,37,11,6,204,0.141,0500000US51005,Alleghany County,15223,178,15045,14542,13754,676,22,59,7,24,503,0.180,0.040,0.280,4.0%,28.0%
0500000US51007,51007,51,7,"Amelia County, Virginia",12690,290,12400,12234,9233,2925,39,27,0,10,166,0.417,0500000US51007,Amelia County,13265,425,12840,12364,9687,2546,18,63,0,50,476,0.428,0.011,0.026,1.1%,2.6%
0500000US51009,51009,51,9,"Amherst County, Virginia",32353,625,31728,31095,24491,6104,296,153,7,44,633,0.391,0500000US51009,Amherst County,31307,838,30469,28908,22967,5346,243,182,25,145,1561,0.429,0.039,0.099,3.9%,9.9%
0500000US51011,51011,51,11,"Appomattox County, Virginia",14973,167,14806,14571,11483,2998,28,35,4,23,235,0.371,0500000US51011,Appomattox County,16119,344,15775,15211,12155,2877,50,42,3,84,564,0.398,0.026,0.071,2.6%,7.1%
0500000US51013,51013,51,13,"Arlington County, Virginia",207627,31382,176245,170949,132961,17088,394,19762,133,611,5296,0.551,0500000US51013,Arlington County,238643,37362,201281,189085,139653,20330,258,27235,118,1491,12196,0.610,0.060,0.108,6.0%,10.8%
0500000US51015,51015,51,15,"Augusta County, Virginia",73750,1525,72225,71451,68011,2881,141,365,13,40,774,0.147,0500000US51015,Augusta County,77487,2728,74759,72263,68375,3072,130,461,27,198,2496,0.217,0.070,0.474,7.0%,47.4%
0500000US51017,51017,51,17,"Bath County, Virginia",4731,101,4630,4593,4363,213,5,7,0,5,37,0.147,0500000US51017,Bath County,4209,73,4136,3980,3841,114,3,17,1,4,156,0.165,0.018,0.121,1.8%,12.1%
0500000US51019,51019,51,19,"Bedford County, Virginia",74898,1224,73674,72853,66706,5154,179,741,15,58,821,0.202,0500000US51019,Bedford County,79462,2055,77407,74488,68128,4864,167,967,33,329,2919,0.259,0.057,0.285,5.7%,28.5%
0500000US51021,51021,51,21,"Bland County, Virginia",6824,39,6785,6742,6494,228,1,18,1,0,43,0.093,0500000US51021,Bland County,6270,60,6210,6033,5857,167,0,4,0,5,177,0.126,0.033,0.350,3.3%,35.0%
0500000US51023,51023,51,23,"Botetourt County, Virginia",33148,356,32792,32460,31212,987,76,174,2,9,332,0.112,0500000US51023,Botetourt County,33596,776,32820,31793,30506,905,43,234,3,102,1027,0.173,0.061,0.543,6.1%,54.3%
0500000US51025,51025,51,25,"Brunswick County, Virginia",17434,298,17136,16982,6943,9944,35,47,4,9,154,0.516,0500000US51025,Brunswick County,15849,387,15462,15129,6457,8573,23,42,5,29,333,0.540,0.025,0.048,2.5%,4.8%
0500000US51027,51027,51,27,"Buchanan County, Virginia",24098,95,24003,23896,23205,614,18,53,2,4,107,0.072,0500000US51027,Buchanan County,20355,177,20178,19898,19210,613,15,49,1,10,280,0.108,0.036,0.501,3.6%,50.1%
0500000US51029,51029,51,29,"Buckingham County, Virginia",17146,288,16858,16598,10494,5979,44,63,1,17,260,0.503,0500000US51029,Buckingham County,16824,413,16411,15859,10314,5390,44,59,0,52,552,0.520,0.017,0.033,1.7%,3.3%
0500000US51031,51031,51,31,"Campbell County, Virginia",54842,918,53924,53084,44595,7737,142,543,11,56,840,0.318,0500000US51031,Campbell County,55696,1815,53881,51664,42884,7761,169,601,8,241,2217,0.385,0.067,0.210,6.7%,21.0%
0500000US51033,51033,51,33,"Caroline County, Virginia",28545,959,27586,26868,18145,8297,189,170,18,49,718,0.510,0500000US51033,Caroline County,30887,1968,28919,27102,18841,7627,160,296,15,163,1817,0.559,0.050,0.097,5.0%,9.7%
0500000US51035,51035,51,35,"Carroll County, Virginia",30042,776,29266,29113,28820,177,49,51,5,11,153,0.079,0500000US51035,Carroll County,29155,1042,28113,27363,27040,163,35,80,3,42,750,0.138,0.059,0.746,5.9%,74.6%
0500000US51036,51036,51,36,"Charles City County, Virginia",7256,88,7168,6992,2939,3511,495,24,5,18,176,0.596,0500000US51036,Charles City County,6773,101,6672,6364,2997,2836,441,34,6,50,308,0.622,0.026,0.043,2.6%,4.3%
0500000US51037,51037,51,37,"Charlotte County, Virginia",12586,240,12346,12193,8383,3739,31,26,0,14,153,0.468,0500000US51037,Charlotte County,11529,253,11276,10899,7677,3140,18,23,6,35,377,0.481,0.013,0.028,1.3%,2.8%
0500000US51041,51041,51,41,"Chesterfield County, Virginia",316236,22864,293372,286804,206792,68196,849,10219,142,606,6568,0.519,0500000US51041,Chesterfield County,364548,40236,324312,308592,210881,81492,848,13096,177,2098,15720,0.600,0.081,0.156,8.1%,15.6%
0500000US51043,51043,51,43,"Clarke County, Virginia",14034,490,13544,13305,12387,742,35,121,5,15,239,0.217,0500000US51043,Clarke County,14783,887,13896,13220,12309,564,33,210,15,89,676,0.299,0.083,0.382,8.3%,38.2%
0500000US51045,51045,51,45,"Craig County, Virginia",5190,36,5154,5123,5103,5,6,8,0,1,31,0.033,0500000US51045,Craig County,4892,53,4839,4673,4631,11,5,11,3,12,166,0.103,0.069,2.094,6.9%,209.4%
0500000US51047,51047,51,47,"Culpeper County, Virginia",46689,4157,42532,41528,33482,7212,129,593,12,100,1004,0.453,0500000US51047,Culpeper County,52552,7509,45043,42423,34840,6453,110,767,20,233,2620,0.522,0.069,0.152,6.9%,15.2%
0500000US51049,51049,51,49,"Cumberland County, Virginia",10052,181,9871,9694,6353,3253,36,35,0,17,177,0.495,0500000US51049,Cumberland County,9675,241,9434,9044,6104,2817,39,36,8,40,390,0.515,0.020,0.040,2.0%,4.0%
0500000US51051,51051,51,51,"Dickenson County, Virginia",15903,86,15817,15750,15650,51,23,17,0,9,67,0.032,0500000US51051,Dickenson County,14124,83,14041,13787,13691,48,22,12,2,12,254,0.060,0.028,0.905,2.8%,90.5%
0500000US51053,51053,51,53,"Dinwiddie County, Virginia",28001,674,27327,26981,17617,9134,83,122,7,18,346,0.497,0500000US51053,Dinwiddie County,27947,1128,26819,25776,17346,8115,91,119,3,102,1043,0.527,0.030,0.061,3.0%,6.1%
0500000US51057,51057,51,57,"Essex County, Virginia",11151,349,10802,10610,6239,4224,46,86,2,13,192,0.542,0500000US51057,Essex County,10599,369,10230,9780,5871,3743,61,62,3,40,450,0.565,0.023,0.043,2.3%,4.3%
0500000US51059,51059,51,59,"Fairfax County, Virginia",1081726,168482,913244,881418,590622,96078,1843,188737,779,3359,31826,0.638,0500000US51059,Fairfax County,1150309,199234,951075,893453,542001,108339,1437,233858,772,7046,57622,0.695,0.057,0.089,5.7%,8.9%
0500000US51061,51061,51,61,"Fauquier County, Virginia",65203,4178,61025,59784,53410,5232,186,826,27,103,1241,0.318,0500000US51061,Fauquier County,72972,7793,65179,61688,54969,4999,128,1204,49,339,3491,0.414,0.096,0.302,9.6%,30.2%
0500000US51063,51063,51,63,"Floyd County, Virginia",15279,412,14867,14726,14385,270,19,35,1,16,141,0.112,0500000US51063,Floyd County,15476,487,14989,14484,14114,234,18,46,0,72,505,0.166,0.053,0.476,5.3%,47.6%
0500000US51065,51065,51,65,"Fluvanna County, Virginia",25691,760,24931,24453,20318,3913,44,136,10,32,478,0.350,0500000US51065,Fluvanna County,27249,1107,26142,24871,20760,3669,68,212,7,155,1271,0.398,0.047,0.135,4.7%,13.5%
0500000US51067,51067,51,67,"Franklin County, Virginia",56159,1424,54735,54130,49072,4541,112,251,10,144,605,0.229,0500000US51067,Franklin County,54477,1955,52522,50617,46218,3848,75,303,20,153,1905,0.273,0.044,0.190,4.4%,19.0%
0500000US51069,51069,51,69,"Frederick County, Virginia",78305,5168,73137,71931,67590,3067,182,959,30,103,1206,0.249,0500000US51069,Frederick County,91419,9990,81429,77566,71739,3605,120,1661,39,402,3863,0.369,0.120,0.482,12.0%,48.2%
0500000US51071,51071,51,71,"Giles County, Virginia",17286,209,17077,16919,16580,259,19,54,0,7,158,0.080,0500000US51071,Giles County,16787,244,16543,16027,15673,238,28,69,0,19,516,0.127,0.047,0.596,4.7%,59.6%
0500000US51073,51073,51,73,"Gloucester County, Virginia",36858,935,35923,35188,31584,3152,129,282,14,27,735,0.257,0500000US51073,Gloucester County,38711,1410,37301,35278,31974,2706,129,305,21,143,2023,0.309,0.051,0.200,5.1%,20.0%
0500000US51075,51075,51,75,"Goochland County, Virginia",21717,455,21262,21032,16583,4151,50,219,4,25,230,0.380,0500000US51075,Goochland County,24727,862,23865,23033,19081,3252,58,493,3,146,832,0.384,0.005,0.012,0.5%,1.2%
0500000US51077,51077,51,77,"Grayson County, Virginia",15533,416,15117,14996,14627,317,30,15,0,7,121,0.112,0500000US51077,Grayson County,15333,596,14737,14365,13396,887,26,24,2,30,372,0.231,0.119,1.064,11.9%,106.4%
0500000US51079,51079,51,79,"Greene County, Virginia",18403,781,17622,17278,15785,1160,38,247,2,46,344,0.258,0500000US51079,Greene County,20552,1330,19222,18234,16214,1442,26,456,4,92,988,0.366,0.108,0.417,10.8%,41.7%
0500000US51081,51081,51,81,"Greensville County, Virginia",12243,173,12070,11991,4628,7294,23,35,1,10,79,0.502,0500000US51081,Greensville County,11391,276,11115,10897,4217,6616,19,32,0,13,218,0.525,0.023,0.045,2.3%,4.5%
0500000US51083,51083,51,83,"Halifax County, Virginia",36241,587,35654,35298,21804,13224,97,132,4,37,356,0.505,0500000US51083,Halifax County,34022,760,33262,32398,20250,11738,77,218,3,112,864,0.525,0.021,0.042,2.1%,4.2%
0500000US51085,51085,51,85,"Hanover County, Virginia",99863,2116,97747,96412,85391,9202,319,1333,31,136,1335,0.260,0500000US51085,Hanover County,109979,3938,106041,101421,88869,9678,311,2021,32,510,4620,0.336,0.076,0.294,7.6%,29.4%
0500000US51087,51087,51,87,"Henrico County, Virginia",306935,15001,291934,285952,174799,89449,844,19956,112,792,5982,0.584,0500000US51087,Henrico County,334389,22085,312304,298507,167030,96332,888,32175,127,1955,13797,0.652,0.068,0.117,6.8%,11.7%
0500000US51089,51089,51,89,"Henry County, Virginia",54151,2545,51606,50882,38737,11786,78,236,2,43,724,0.438,0500000US51089,Henry County,50948,3301,47647,45880,34307,11062,68,284,6,153,1767,0.494,0.055,0.127,5.5%,12.7%
0500000US51091,51091,51,91,"Highland County, Virginia",2321,18,2303,2298,2284,6,4,4,0,0,5,0.032,0500000US51091,Highland County,2232,35,2197,2150,2132,2,1,6,1,8,47,0.087,0.055,1.754,5.5%,175.4%
0500000US51093,51093,51,93,"Isle of Wight County, Virginia",35270,658,34612,34071,24969,8656,104,275,13,54,541,0.438,0500000US51093,Isle of Wight County,38606,1199,37407,35752,26410,8579,139,391,31,202,1655,0.480,0.042,0.095,4.2%,9.5%
0500000US51095,51095,51,95,"James City County, Virginia",67009,3024,63985,62553,52049,8662,173,1488,54,127,1432,0.377,0500000US51095,James City County,78254,5199,73055,69307,56647,9832,165,2254,48,361,3748,0.453,0.076,0.201,7.6%,20.1%
0500000US51097,51097,51,97,"King and Queen County, Virginia",6945,184,6761,6650,4547,1970,109,17,0,7,111,0.490,0500000US51097,King and Queen County,6608,182,6426,6148,4460,1561,82,23,3,19,278,0.486,-0.004,-0.008,-0.4%,-0.8%
0500000US51099,51099,51,99,"King George County, Virginia",23584,790,22794,22200,17603,4177,101,268,10,41,594,0.410,0500000US51099,King George County,26723,1582,25141,23342,18709,3919,153,401,13,147,1799,0.480,0.070,0.172,7.0%,17.2%
0500000US51101,51101,51,101,"King William County, Virginia",15935,324,15611,15269,12107,2806,223,118,3,12,342,0.391,0500000US51101,King William County,17810,476,17334,16575,13499,2585,277,129,9,76,759,0.402,0.011,0.028,1.1%,2.8%
0500000US51103,51103,51,103,"Lancaster County, Virginia",11391,118,11273,11177,7925,3166,16,65,0,5,96,0.439,0500000US51103,Lancaster County,10919,125,10794,10518,7441,2946,14,77,1,39,276,0.462,0.023,0.054,2.3%,5.4%
0500000US51105,51105,51,105,"Lee County, Virginia",25587,406,25181,24983,23893,909,96,55,8,22,198,0.126,0500000US51105,Lee County,22173,476,21697,21202,20193,868,69,39,0,33,495,0.168,0.042,0.330,4.2%,33.0%
0500000US51107,51107,51,107,"Loudoun County, Virginia",312311,38576,273735,264045,194845,21934,520,45795,143,808,9690,0.568,0500000US51107,Loudoun County,420959,59744,361215,339150,216865,29725,536,89372,227,2425,22065,0.662,0.094,0.165,9.4%,16.5%
0500000US51109,51109,51,109,"Louisa County, Virginia",33153,762,32391,31714,25562,5832,106,158,15,41,677,0.374,0500000US51109,Louisa County,37596,1365,36231,34417,28535,5365,93,251,18,155,1814,0.400,0.026,0.070,2.6%,7.0%
0500000US51111,51111,51,111,"Lunenburg County, Virginia",12914,470,12444,12255,7730,4451,37,25,3,9,189,0.521,0500000US51111,Lunenburg County,11936,589,11347,10882,7016,3773,32,25,5,31,465,0.551,0.029,0.056,2.9%,5.6%
0500000US51113,51113,51,113,"Madison County, Virginia",13308,236,13072,12796,11394,1292,22,74,4,10,276,0.257,0500000US51113,Madison County,13837,441,13396,12773,11563,1056,14,86,1,53,623,0.293,0.036,0.140,3.6%,14.0%
0500000US51115,51115,51,115,"Mathews County, Virginia",8978,104,8874,8708,7835,822,18,30,2,1,166,0.230,0500000US51115,Mathews County,8533,197,8336,8004,7250,658,7,49,15,25,332,0.270,0.041,0.177,4.1%,17.7%
0500000US51117,51117,51,117,"Mecklenburg County, Virginia",32727,806,31921,31491,19215,11958,73,213,10,22,430,0.521,0500000US51117,Mecklenburg County,30319,821,29498,28616,17864,10364,73,205,0,110,882,0.534,0.013,0.026,1.3%,2.6%
0500000US51119,51119,51,119,"Middlesex County, Virginia",10959,166,10793,10638,8604,1956,35,37,1,5,155,0.351,0500000US51119,Middlesex County,10625,259,10366,9951,8339,1519,24,26,3,40,415,0.361,0.010,0.029,1.0%,2.9%
0500000US51121,51121,51,121,"Montgomery County, Virginia",94392,2536,91856,90103,81091,3631,154,5089,21,117,1753,0.257,0500000US51121,Montgomery County,99721,4651,95070,90760,77918,4054,126,8310,45,307,4310,0.377,0.120,0.469,12.0%,46.9%
0500000US51125,51125,51,125,"Nelson County, Virginia",15020,459,14561,14360,12283,1941,43,66,4,23,201,0.313,0500000US51125,Nelson County,14775,663,14112,13589,11879,1526,47,67,2,68,523,0.340,0.026,0.084,2.6%,8.4%
0500000US51127,51127,51,127,"New Kent County, Virginia",18429,390,18039,17645,14804,2474,185,159,2,21,394,0.336,0500000US51127,New Kent County,22945,731,22214,21090,17818,2714,225,223,8,102,1124,0.379,0.044,0.130,4.4%,13.0%
0500000US51131,51131,51,131,"Northampton County, Virginia",12389,874,11515,11370,6755,4491,26,81,2,15,145,0.566,0500000US51131,Northampton County,12282,1068,11214,10864,6932,3756,58,80,8,30,350,0.579,0.013,0.024,1.3%,2.4%
0500000US51133,51133,51,133,"Northumberland County, Virginia",12330,382,11948,11809,8638,3106,20,36,2,7,139,0.445,0500000US51133,Northumberland County,11839,351,11488,11123,8310,2673,14,67,0,59,365,0.454,0.010,0.022,1.0%,2.2%
0500000US51135,51135,51,135,"Nottoway County, Virginia",15853,609,15244,15089,8799,6179,42,50,3,16,155,0.538,0500000US51135,Nottoway County,15642,773,14869,14414,8452,5773,50,64,3,72,455,0.568,0.030,0.056,3.0%,5.6%
0500000US51137,51137,51,137,"Orange County, Virginia",33481,1139,32342,31623,27033,4206,80,240,15,49,719,0.331,0500000US51137,Orange County,36254,2171,34083,32270,27389,4304,92,311,18,156,1813,0.409,0.078,0.237,7.8%,23.7%
0500000US51139,51139,51,139,"Page County, Virginia",24042,373,23669,23448,22871,456,37,71,7,6,221,0.094,0500000US51139,Page County,23709,497,23212,22518,21870,436,49,115,8,40,694,0.147,0.053,0.563,5.3%,56.3%
0500000US51141,51141,51,141,"Patrick County, Virginia",18490,444,18046,17865,16680,1085,50,42,0,8,181,0.182,0500000US51141,Patrick County,17608,567,17041,16550,15577,831,24,43,3,72,491,0.213,0.031,0.172,3.1%,17.2%
0500000US51143,51143,51,143,"Pittsylvania County, Virginia",63506,1332,62174,61572,47250,13963,124,176,17,42,602,0.398,0500000US51143,Pittsylvania County,60501,1712,58789,57158,44277,12354,93,289,17,128,1631,0.421,0.024,0.059,2.4%,5.9%
0500000US51145,51145,51,145,"Powhatan County, Virginia",28046,502,27544,27261,23231,3798,75,131,10,16,283,0.295,0500000US51145,Powhatan County,30333,792,29541,28317,25497,2477,59,167,18,99,1224,0.284,-0.011,-0.036,-1.1%,-3.6%
0500000US51147,51147,51,147,"Prince Edward County, Virginia",23368,525,22843,22523,14544,7668,60,203,15,33,320,0.504,0500000US51147,Prince Edward County,21849,1088,20761,19997,10513,9194,33,196,0,61,764,0.588,0.083,0.165,8.3%,16.5%
0500000US51149,51149,51,149,"Prince George County, Virginia",35725,2058,33667,32837,20822,11150,184,520,100,61,830,0.559,0500000US51149,Prince George County,43010,4344,38666,36731,22662,12694,221,822,141,191,1935,0.623,0.064,0.114,6.4%,11.4%
0500000US51153,51153,51,153,"Prince William County, Virginia",402002,81460,320542,306759,195656,78492,984,29986,414,1227,13783,0.677,0500000US51153,Prince William County,482204,121524,360680,334459,185048,94939,745,49836,507,3384,26221,0.737,0.060,0.088,6.0%,8.8%
0500000US51155,51155,51,155,"Pulaski County, Virginia",34872,432,34440,33988,31972,1744,61,179,7,25,452,0.157,0500000US51155,Pulaski County,33800,704,33096,31678,29716,1633,49,177,3,100,1418,0.222,0.066,0.421,6.6%,42.1%
0500000US51157,51157,51,157,"Rappahannock County, Virginia",7373,228,7145,7037,6653,318,15,39,3,9,108,0.183,0500000US51157,Rappahannock County,7348,289,7059,6752,6444,198,17,63,0,30,307,0.227,0.044,0.241,4.4%,24.1%
0500000US51159,51159,51,159,"Richmond County, Virginia",9254,510,8744,8617,5755,2793,24,39,2,4,127,0.519,0500000US51159,Richmond County,8923,597,8326,8046,5564,2419,16,42,0,5,280,0.532,0.013,0.026,1.3%,2.6%
0500000US51161,51161,51,161,"Roanoke County, Virginia",92376,1951,90425,89157,81886,4580,121,2455,26,89,1268,0.210,0500000US51161,Roanoke County,96929,3507,93422,89617,79928,5650,155,3425,24,435,3805,0.313,0.102,0.485,10.2%,48.5%
0500000US51163,51163,51,163,"Rockbridge County, Virginia",22307,296,22011,21720,20915,585,99,103,3,15,291,0.120,0500000US51163,Rockbridge County,22650,513,22137,21276,20357,565,85,181,6,82,861,0.190,0.070,0.582,7.0%,58.2%
0500000US51165,51165,51,165,"Rockingham County, Virginia",76314,4076,72238,71445,69640,1216,83,454,8,44,793,0.164,0500000US51165,Rockingham County,83757,7093,76664,74387,71367,1768,80,920,9,243,2277,0.265,0.101,0.619,10.1%,61.9%
0500000US51167,51167,51,167,"Russell County, Virginia",28897,275,28622,28472,28142,227,40,53,1,9,150,0.051,0500000US51167,Russell County,25781,168,25613,25061,24754,222,17,42,1,25,552,0.078,0.026,0.508,2.6%,50.8%
0500000US51169,51169,51,169,"Scott County, Virginia",23177,234,22943,22806,22585,135,48,35,0,3,137,0.050,0500000US51169,Scott County,21576,255,21321,20738,20528,134,26,20,2,28,583,0.094,0.044,0.868,4.4%,86.8%
0500000US51171,51171,51,171,"Shenandoah County, Virginia",41993,2577,39416,38900,37886,699,71,210,6,28,516,0.182,0500000US51171,Shenandoah County,44186,3726,40460,38920,37304,1031,84,344,8,149,1540,0.278,0.096,0.531,9.6%,53.1%
0500000US51173,51173,51,173,"Smyth County, Virginia",32208,527,31681,31416,30642,630,41,82,3,18,265,0.094,0500000US51173,Smyth County,29800,558,29242,28360,27762,408,36,104,1,49,882,0.131,0.037,0.388,3.7%,38.8%
0500000US51175,51175,51,175,"Southampton County, Virginia",18570,203,18367,18147,11138,6893,52,46,5,13,220,0.502,0500000US51175,Southampton County,17996,332,17664,17060,10959,5908,56,67,20,50,604,0.520,0.018,0.035,1.8%,3.5%
0500000US51177,51177,51,177,"Spotsylvania County, Virginia",122397,9278,113119,109873,88077,18298,323,2768,135,272,3246,0.453,0500000US51177,Spotsylvania County,140032,16654,123378,114989,87278,22436,375,3933,122,845,8389,0.567,0.114,0.253,11.4%,25.3%
0500000US51179,51179,51,179,"Stafford County, Virginia",128961,11875,117086,113134,87434,21259,454,3545,149,293,3952,0.503,0500000US51179,Stafford County,156927,23646,133281,123163,85587,29492,601,6137,241,1105,10118,0.639,0.136,0.270,13.6%,27.0%
0500000US51181,51181,51,181,"Surry County, Virginia",7058,86,6972,6873,3583,3240,21,23,2,4,99,0.531,0500000US51181,Surry County,6561,149,6412,6202,3459,2687,17,14,10,15,210,0.553,0.022,0.041,2.2%,4.1%
0500000US51183,51183,51,183,"Sussex County, Virginia",12087,268,11819,11733,4663,6996,19,46,0,9,86,0.516,0500000US51183,Sussex County,10829,306,10523,10204,4381,5766,14,11,7,25,319,0.551,0.036,0.069,3.6%,6.9%
0500000US51185,51185,51,185,"Tazewell County, Virginia",45078,296,44782,44391,42692,1330,54,286,6,23,391,0.102,0500000US51185,Tazewell County,40429,507,39922,38670,37336,961,56,213,15,89,1252,0.145,0.043,0.425,4.3%,42.5%
0500000US51187,51187,51,187,"Warren County, Virginia",37575,1318,36257,35549,33345,1709,103,350,7,35,708,0.209,0500000US51187,Warren County,40727,2413,38314,36413,33831,1722,130,462,13,255,1901,0.302,0.094,0.448,9.4%,44.8%
0500000US51191,51191,51,191,"Washington County, Virginia",54876,724,54152,53803,52798,686,90,202,6,21,349,0.074,0500000US51191,Washington County,53935,891,53044,51548,50338,651,91,334,0,134,1496,0.128,0.054,0.728,5.4%,72.8%
0500000US51193,51193,51,193,"Westmoreland County, Virginia",17454,1002,16452,16114,11087,4855,64,91,3,14,338,0.515,0500000US51193,Westmoreland County,18477,1049,17428,16520,11758,4470,67,146,11,68,908,0.531,0.015,0.030,1.5%,3.0%
0500000US51195,51195,51,195,"Wise County, Virginia",41452,471,40981,40633,38301,2118,51,141,2,20,348,0.143,0500000US51195,Wise County,36130,452,35678,34652,32586,1771,48,150,11,86,1026,0.183,0.040,0.277,4.0%,27.7%
0500000US51197,51197,51,197,"Wythe County, Virginia",29235,280,28955,28637,27649,809,39,124,3,13,318,0.105,0500000US51197,Wythe County,28290,355,27935,27021,26082,699,54,118,2,66,914,0.148,0.044,0.417,4.4%,41.7%
0500000US51199,51199,51,199,"York County, Virginia",65464,2892,62572,60691,48470,8599,225,3169,92,136,1881,0.429,0500000US51199,York County,70045,5136,64909,60527,46932,8633,168,4251,127,416,4382,0.523,0.093,0.218,9.3%,21.8%
0500000US51510,51510,51,510,"Alexandria city, Virginia",139966,22524,117442,113928,74878,29778,327,8351,109,485,3514,0.638,0500000US51510,Alexandria city,159467,29372,130095,122358,78519,31314,217,11205,77,1026,7737,0.678,0.039,0.062,3.9%,6.2%
0500000US51520,51520,51,520,"Bristol city, Virginia",17835,221,17614,17297,16099,1000,49,121,4,24,317,0.182,0500000US51520,Bristol city,17219,455,16764,15914,14652,1008,55,159,4,36,850,0.269,0.088,0.483,8.8%,48.3%
0500000US51530,51530,51,530,"Buena Vista city, Virginia",6650,103,6547,6439,5982,345,71,29,12,0,108,0.187,0500000US51530,Buena Vista city,6641,229,6412,6054,5660,289,39,24,24,18,358,0.268,0.080,0.427,8.0%,42.7%
0500000US51540,51540,51,540,"Charlottesville city, Virginia",43475,2223,41252,40096,28827,8344,65,2758,13,89,1156,0.516,0500000US51540,Charlottesville city,46553,3207,43346,41005,29609,7030,66,4064,18,218,2341,0.558,0.042,0.081,4.2%,8.1%
0500000US51550,51550,51,550,"Chesapeake city, Virginia",222209,9706,212503,206877,134251,65204,720,6289,147,266,5626,0.546,0500000US51550,Chesapeake city,249422,17824,231598,217698,135679,70885,731,8868,312,1223,13900,0.614,0.068,0.125,6.8%,12.5%
0500000US51570,51570,51,570,"Colonial Heights city, Virginia",17411,674,16737,16407,14020,1732,63,570,8,14,330,0.339,0500000US51570,Colonial Heights city,18170,1276,16894,15956,12409,2848,32,569,13,85,938,0.500,0.162,0.477,16.2%,47.7%
0500000US51580,51580,51,580,"Covington city, Virginia",5961,92,5869,5755,4955,741,18,33,0,8,114,0.293,0500000US51580,Covington city,5737,179,5558,5317,4541,716,12,32,5,11,241,0.355,0.062,0.212,6.2%,21.2%
0500000US51590,51590,51,590,"Danville city, Virginia",43055,1245,41810,41336,20107,20725,66,394,11,33,474,0.549,0500000US51590,Danville city,42590,2074,40516,39352,16884,21733,88,503,1,143,1164,0.579,0.030,0.055,3.0%,5.5%
0500000US51595,51595,51,595,"Emporia city, Virginia",5927,262,5665,5595,1848,3685,8,43,4,7,70,0.514,0500000US51595,Emporia city,5766,345,5421,5258,1529,3631,7,50,4,37,163,0.529,0.015,0.028,1.5%,2.8%
0500000US51600,51600,51,600,"Fairfax city, Virginia",22565,3556,19009,18403,13849,1030,62,3403,11,48,606,0.573,0500000US51600,Fairfax city,24146,4278,19868,18739,12911,1052,44,4519,9,204,1129,0.644,0.071,0.123,7.1%,12.3%
0500000US51610,51610,51,610,"Falls Church city, Virginia",12332,1109,11223,10813,9093,523,23,1150,4,20,410,0.437,0500000US51610,Falls Church city,14658,1529,13129,12142,9955,554,12,1494,10,117,987,0.511,0.075,0.171,7.5%,17.1%
0500000US51620,51620,51,620,"Franklin city, Virginia",8582,141,8441,8300,3333,4867,27,63,2,8,141,0.527,0500000US51620,Franklin city,8180,218,7962,7700,2966,4610,25,81,2,16,262,0.549,0.022,0.042,2.2%,4.2%
0500000US51630,51630,51,630,"Fredericksburg city, Virginia",24286,2607,21679,20935,14760,5367,58,670,16,64,744,0.569,0500000US51630,Fredericksburg city,27982,3472,24510,22872,15201,5956,86,1325,24,280,1638,0.638,0.070,0.123,7.0%,12.3%
0500000US51640,51640,51,640,"Galax city, Virginia",7042,989,6053,5962,5501,407,7,37,3,7,91,0.367,0500000US51640,Galax city,6720,1061,5659,5409,4975,354,13,52,0,15,250,0.423,0.056,0.153,5.6%,15.3%
0500000US51650,51650,51,650,"Hampton city, Virginia",137436,6241,131195,127007,56283,66878,498,2950,132,266,4188,0.592,0500000US51650,Hampton city,137148,8411,128737,121103,49389,66632,485,3493,209,895,7634,0.627,0.035,0.059,3.5%,5.9%
0500000US51660,51660,51,660,"Harrisonburg city, Virginia",48914,7665,41249,40240,35391,2911,67,1705,54,112,1009,0.447,0500000US51660,Harrisonburg city,51814,12045,39769,37736,31454,3906,71,2089,20,196,2033,0.569,0.122,0.273,12.2%,27.3%
0500000US51670,51670,51,670,"Hopewell city, Virginia",22591,1480,21111,20533,12005,8216,78,174,23,37,578,0.580,0500000US51670,Hopewell city,23033,1889,21144,19989,9819,9689,86,251,15,129,1155,0.632,0.052,0.089,5.2%,8.9%
0500000US51678,51678,51,678,"Lexington city, Virginia",7042,271,6771,6652,5807,668,8,153,4,12,119,0.309,0500000US51678,Lexington city,7320,335,6985,6781,6015,454,8,281,0,23,204,0.317,0.008,0.025,0.8%,2.5%
0500000US51680,51680,51,680,"Lynchburg city, Virginia",75568,2300,73268,71821,47574,21984,200,1852,27,184,1447,0.517,0500000US51680,Lynchburg city,79009,3880,75129,71537,47654,21228,200,1752,34,669,3592,0.559,0.042,0.081,4.2%,8.1%
0500000US51683,51683,51,683,"Manassas city, Virginia",37821,11876,25945,25025,17994,4905,99,1861,41,125,920,0.655,0500000US51683,Manassas city,42772,18345,24427,22834,14816,4914,65,2703,19,317,1593,0.677,0.022,0.034,2.2%,3.4%
0500000US51685,51685,51,685,"Manassas Park city, Virginia",14273,4645,9628,9211,6070,1784,31,1261,17,48,417,0.689,0500000US51685,Manassas Park city,17219,7799,9420,8782,4706,2076,27,1827,13,133,638,0.693,0.004,0.006,0.4%,0.6%
0500000US51690,51690,51,690,"Martinsville city, Virginia",13821,552,13269,13053,6707,6191,18,127,0,10,216,0.562,0500000US51690,Martinsville city,13485,1025,12460,11964,5732,6043,23,116,4,46,496,0.611,0.049,0.088,4.9%,8.8%
0500000US51700,51700,51,700,"Newport News city, Virginia",180719,13590,167129,161012,83153,71727,682,4858,284,308,6117,0.623,0500000US51700,Newport News city,186247,19288,166959,156449,71250,76870,571,6230,404,1124,10510,0.668,0.045,0.072,4.5%,7.2%
0500000US51710,51710,51,710,"Norfolk city, Virginia",242803,16144,226659,219541,107463,102452,935,7861,359,471,7118,0.620,0500000US51710,Norfolk city,238005,23130,214875,202224,97205,93553,832,8828,475,1331,12651,0.665,0.045,0.073,4.5%,7.3%
0500000US51720,51720,51,720,"Norton city, Virginia",3958,68,3890,3795,3478,250,5,56,0,6,95,0.223,0500000US51720,Norton city,3687,81,3606,3447,3223,179,4,27,0,14,159,0.231,0.008,0.037,0.8%,3.7%
0500000US51730,51730,51,730,"Petersburg city, Virginia",32420,1216,31204,30714,4902,25419,87,263,12,31,490,0.361,0500000US51730,Petersburg city,33458,1970,31488,30363,5178,24530,105,330,30,190,1125,0.434,0.073,0.203,7.3%,20.3%
0500000US51735,51735,51,735,"Poquoson city, Virginia",12150,221,11929,11778,11398,78,34,259,3,6,151,0.119,0500000US51735,Poquoson city,12460,463,11997,11399,10937,107,33,253,2,67,598,0.225,0.106,0.894,10.6%,89.4%
0500000US51740,51740,51,740,"Portsmouth city, Virginia",95535,2919,92616,90448,38526,50327,379,994,104,118,2168,0.558,0500000US51740,Portsmouth city,97915,4413,93502,88721,34912,51586,355,1244,134,490,4781,0.591,0.032,0.058,3.2%,5.8%
0500000US51750,51750,51,750,"Radford city, Virginia",16408,385,16023,15646,14075,1262,30,251,5,23,377,0.257,0500000US51750,Radford city,16070,765,15305,14640,12006,2125,30,210,0,269,665,0.420,0.163,0.634,16.3%,63.4%
0500000US51760,51760,51,760,"Richmond city, Virginia",204214,12803,191411,187730,79813,102264,514,4679,93,367,3681,0.592,0500000US51760,Richmond city,226610,23747,202863,193796,95220,90490,440,6199,69,1378,9067,0.651,0.059,0.100,5.9%,10.0%
0500000US51770,51770,51,770,"Roanoke city, Virginia",97032,5345,91687,89407,60042,27256,198,1676,36,199,2280,0.534,0500000US51770,Roanoke city,100011,8484,91527,86266,55951,27077,211,2462,42,523,5261,0.603,0.069,0.129,6.9%,12.9%
0500000US51775,51775,51,775,"Salem city, Virginia",24802,601,24201,23875,21653,1732,55,398,6,31,326,0.232,0500000US51775,Salem city,25346,1088,24258,23233,20673,1913,42,534,5,66,1025,0.325,0.093,0.402,9.3%,40.2%
0500000US51790,51790,51,790,"Staunton city, Virginia",23746,513,23233,22730,19584,2859,41,182,3,61,503,0.304,0500000US51790,Staunton city,25750,1088,24662,23392,19959,2882,65,320,11,155,1270,0.382,0.078,0.256,7.8%,25.6%
0500000US51800,51800,51,800,"Suffolk city, Virginia",84585,2415,82170,80520,43034,35771,232,1324,50,109,1650,0.561,0500000US51800,Suffolk city,94324,4252,90072,85569,43837,39194,255,1672,68,543,4503,0.607,0.046,0.082,4.6%,8.2%
0500000US51810,51810,51,810,"Virginia Beach city, Virginia",437994,28987,409007,394806,282470,83210,1349,26312,602,863,14201,0.539,0500000US51810,Virginia Beach city,459470,40404,419066,390359,269566,82583,1184,33756,671,2599,28707,0.606,0.067,0.125,6.7%,12.5%
0500000US51820,51820,51,820,"Waynesboro city, Virginia",21006,1337,19669,19118,16704,2176,50,154,5,29,551,0.352,0500000US51820,Waynesboro city,22196,1945,20251,19099,16074,2610,33,258,20,104,1152,0.451,0.099,0.281,9.9%,28.1%
0500000US51830,51830,51,830,"Williamsburg city, Virginia",14068,941,13127,12734,9952,1918,35,802,4,23,393,0.472,0500000US51830,Williamsburg city,15425,1215,14210,13613,7370,5648,20,497,25,53,597,0.629,0.156,0.331,15.6%,33.1%
0500000US51840,51840,51,840,"Winchester city, Virginia",26203,4041,22162,21564,18085,2783,37,599,3,57,598,0.488,0500000US51840,Winchester city,28120,5494,22626,21338,17623,2800,66,700,14,135,1288,0.556,0.069,0.141,6.9%,14.1%
0500000US53001,53001,53,1,"Adams County, Washington",18728,11099,7629,7505,7262,47,76,99,3,18,124,0.498,0500000US53001,Adams County,20613,13120,7493,7135,6829,24,63,129,3,87,358,0.485,-0.014,-0.027,-1.4%,-2.7%
0500000US53003,53003,53,3,"Asotin County, Washington",21623,643,20980,20549,20026,89,272,114,36,12,431,0.141,0500000US53003,Asotin County,22285,915,21370,20176,19473,113,262,206,34,88,1194,0.232,0.091,0.645,9.1%,64.5%
0500000US53005,53005,53,5,"Benton County, Washington",175177,32696,142481,138850,130437,2031,1280,4621,221,260,3631,0.409,0500000US53005,Benton County,206873,49339,157534,147359,135718,2621,1191,6244,536,1049,10175,0.509,0.100,0.244,10.0%,24.4%
0500000US53007,53007,53,7,"Chelan County, Washington",72453,18713,53740,52628,51202,177,514,570,89,76,1112,0.434,0500000US53007,Chelan County,79074,22104,56970,54031,52093,253,408,787,109,381,2939,0.486,0.053,0.122,5.3%,12.2%
0500000US53009,53009,53,9,"Clallam County, Washington",71404,3627,67777,65477,60400,558,3326,993,86,114,2300,0.278,0500000US53009,Clallam County,77155,4732,72423,67445,61164,571,3931,1234,113,432,4978,0.361,0.082,0.295,8.2%,29.5%
0500000US53011,53011,53,11,"Clark County, Washington",425363,32166,393197,379292,347793,8025,2970,17276,2589,639,13905,0.323,0500000US53011,Clark County,503311,58790,444521,412201,366727,10850,3051,23910,5127,2536,32320,0.448,0.126,0.390,12.6%,39.0%
0500000US53013,53013,53,13,"Columbia County, Washington",4078,254,3824,3754,3649,12,47,23,14,9,70,0.195,0500000US53013,Columbia County,3952,304,3648,3433,3347,6,41,21,0,18,215,0.274,0.079,0.404,7.9%,40.4%
0500000US53015,53015,53,15,"Cowlitz County, Washington",102410,7975,94435,91503,87825,572,1361,1472,209,64,2932,0.257,0500000US53015,Cowlitz County,110730,10802,99928,93071,88067,746,1409,1721,643,485,6857,0.354,0.096,0.375,9.6%,37.5%
0500000US53017,53017,53,17,"Douglas County, Washington",38431,11013,27418,26820,26070,85,293,269,51,52,598,0.457,0500000US53017,Douglas County,42938,14637,28301,26564,25445,117,338,406,55,203,1737,0.531,0.073,0.161,7.3%,16.1%
0500000US53019,53019,53,19,"Ferry County, Washington",7551,254,7297,6963,5662,18,1215,52,8,8,334,0.409,0500000US53019,Ferry County,7178,210,6968,6460,5056,21,1293,43,11,36,508,0.465,0.057,0.139,5.7%,13.9%
0500000US53021,53021,53,21,"Franklin County, Washington",78163,40004,38159,37072,33804,1339,357,1384,92,96,1087,0.550,0500000US53021,Franklin County,96749,52445,44304,41594,37225,1603,437,1796,195,338,2710,0.557,0.006,0.012,0.6%,1.2%
0500000US53023,53023,53,23,"Garfield County, Washington",2266,91,2175,2149,2102,0,5,38,0,4,26,0.137,0500000US53023,Garfield County,2286,110,2176,2090,2055,3,18,9,0,5,86,0.188,0.051,0.368,5.1%,36.8%
0500000US53025,53025,53,25,"Grant County, Washington",89120,34163,54957,53487,51066,710,779,783,54,95,1470,0.524,0500000US53025,Grant County,99123,42401,56722,53377,50250,651,830,1153,96,397,3345,0.559,0.034,0.066,3.4%,6.6%
0500000US53027,53027,53,27,"Grays Harbor County, Washington",72797,6272,66525,64293,59282,762,3005,995,177,72,2232,0.326,0500000US53027,Grays Harbor County,75636,7834,67802,63097,57068,972,3495,1024,127,411,4705,0.414,0.087,0.267,8.7%,26.7%
0500000US53029,53029,53,29,"Island County, Washington",78506,4295,74211,71268,65209,1641,561,3377,370,110,2943,0.303,0500000US53029,Island County,86857,7118,79739,73556,65856,2265,543,3916,414,562,6183,0.411,0.107,0.353,10.7%,35.3%
0500000US53031,53031,53,31,"Jefferson County, Washington",29872,848,29024,28129,26681,237,628,460,62,61,895,0.200,0500000US53031,Jefferson County,32977,1305,31672,29710,28216,207,522,487,49,229,1962,0.262,0.062,0.313,6.2%,31.3%
0500000US53033,53033,53,33,"King County, Washington",1931249,172378,1758871,1679342,1251300,116326,12931,280029,14068,4688,79529,0.546,0500000US53033,King County,2269675,243021,2026654,1872895,1230588,147831,11810,449729,19399,13538,153759,0.646,0.101,0.184,10.1%,18.4%
0500000US53035,53035,53,35,"Kitsap County, Washington",251133,15686,235447,223280,198745,6329,3524,12082,2177,423,12167,0.364,0500000US53035,Kitsap County,275611,24184,251427,228460,199020,7338,3491,14015,2814,1782,22967,0.460,0.096,0.264,9.6%,26.4%
0500000US53037,53037,53,37,"Kittitas County, Washington",40915,3121,37794,36809,35214,339,353,795,56,52,985,0.252,0500000US53037,Kittitas County,44337,4594,39743,37350,35323,380,407,907,87,246,2393,0.351,0.099,0.391,9.9%,39.1%
0500000US53039,53039,53,39,"Klickitat County, Washington",20318,2171,18147,17652,17022,42,434,122,17,15,495,0.286,0500000US53039,Klickitat County,22735,2913,19822,18581,17731,64,503,135,35,113,1241,0.372,0.086,0.302,8.6%,30.2%
0500000US53041,53041,53,41,"Lewis County, Washington",75455,6527,68928,67022,64881,370,952,643,103,73,1906,0.252,0500000US53041,Lewis County,82149,8830,73319,68360,65496,530,978,796,157,403,4959,0.349,0.097,0.383,9.7%,38.3%
0500000US53043,53043,53,43,"Lincoln County, Washington",10570,239,10331,10129,9891,25,162,41,5,5,202,0.123,0500000US53043,Lincoln County,10876,385,10491,9933,9576,15,204,67,14,57,558,0.220,0.097,0.789,9.7%,78.9%
0500000US53045,53045,53,45,"Mason County, Washington",60699,4844,55855,53809,50349,609,1864,692,214,81,2046,0.303,0500000US53045,Mason County,65726,7595,58131,53634,49591,688,1959,758,216,422,4497,0.411,0.108,0.357,10.8%,35.7%
0500000US53047,53047,53,47,"Okanogan County, Washington",41120,7227,33893,32906,28092,131,4391,223,27,42,987,0.490,0500000US53047,Okanogan County,42104,8197,33907,31848,26522,159,4588,268,40,271,2059,0.551,0.061,0.124,6.1%,12.4%
0500000US53049,53049,53,49,"Pacific County, Washington",20920,1677,19243,18644,17699,67,427,424,14,13,599,0.276,0500000US53049,Pacific County,23365,2196,21169,19829,18609,100,501,461,39,119,1340,0.353,0.077,0.277,7.7%,27.7%
0500000US53051,53051,53,51,"Pend Oreille County, Washington",13001,391,12610,12306,11677,50,466,73,16,24,304,0.191,0500000US53051,Pend Oreille County,13401,448,12953,12254,11684,54,373,69,9,65,699,0.235,0.045,0.234,4.5%,23.4%
0500000US53053,53053,53,53,"Pierce County, Washington",795225,72849,722376,677879,559160,51436,9143,46520,10205,1415,44497,0.486,0500000US53053,Pierce County,921130,111811,809319,728384,569815,63059,9642,62126,18182,5560,80935,0.585,0.099,0.204,9.9%,20.4%
0500000US53055,53055,53,55,"San Juan County, Washington",15769,857,14912,14589,14228,49,84,179,14,35,323,0.182,0500000US53055,San Juan County,17788,1298,16490,15533,15024,48,92,224,23,122,957,0.278,0.096,0.525,9.6%,52.5%
0500000US53057,53057,53,57,"Skagit County, Washington",116901,19709,97192,94736,89694,640,2038,2025,180,159,2456,0.382,0500000US53057,Skagit County,129523,23792,105731,99074,92347,793,2052,2771,388,723,6657,0.454,0.073,0.190,7.3%,19.0%
0500000US53059,53059,53,59,"Skamania County, Washington",11066,553,10513,10226,9918,44,150,96,11,7,287,0.193,0500000US53059,Skamania County,12036,765,11271,10530,10060,72,170,120,29,79,741,0.293,0.100,0.517,10.0%,51.7%
0500000US53061,53061,53,61,"Snohomish County, Washington",713335,64249,649086,622546,529814,17299,8451,62760,3002,1220,26540,0.430,0500000US53061,Snohomish County,827957,95644,732313,675110,528415,28392,7993,100654,4851,4805,57203,0.558,0.128,0.298,12.8%,29.8%
0500000US53063,53063,53,63,"Spokane County, Washington",471221,21260,449961,435047,408629,7714,6478,9799,1817,610,14914,0.244,0500000US53063,Spokane County,539339,35350,503989,468404,431806,10486,6862,12404,4202,2644,35585,0.349,0.105,0.431,10.5%,43.1%
0500000US53065,53065,53,65,"Stevens County, Washington",43531,1185,42346,41050,38261,145,2275,234,62,73,1296,0.223,0500000US53065,Stevens County,46445,1685,44760,42073,38722,141,2558,280,84,288,2687,0.297,0.074,0.332,7.4%,33.2%
0500000US53067,53067,53,67,"Thurston County, Washington",252264,17787,234477,223554,199019,6420,3009,12820,1869,417,10923,0.367,0500000US53067,Thurston County,294793,29024,265769,242400,207985,8893,3621,16878,3241,1782,23369,0.482,0.114,0.312,11.4%,31.2%
0500000US53069,53069,53,69,"Wahkiakum County, Washington",3978,108,3870,3766,3678,8,48,22,6,4,104,0.144,0500000US53069,Wahkiakum County,4422,183,4239,3962,3817,21,55,43,2,24,277,0.249,0.105,0.735,10.5%,73.5%
0500000US53071,53071,53,71,"Walla Walla County, Washington",58781,11593,47188,46006,43604,1004,452,733,159,54,1182,0.410,0500000US53071,Walla Walla County,62584,14206,48378,45311,42580,981,418,918,134,280,3067,0.483,0.073,0.177,7.3%,17.7%
0500000US53073,53073,53,73,"Whatcom County, Washington",201140,15756,185384,179346,164675,1789,5070,6988,459,365,6038,0.321,0500000US53073,Whatcom County,226847,22825,204022,190027,170385,2221,5459,9952,672,1338,13995,0.419,0.099,0.307,9.9%,30.7%
0500000US53075,53075,53,75,"Whitman County, Washington",44776,2040,42736,41343,36760,721,272,3449,99,42,1393,0.317,0500000US53075,Whitman County,47973,4052,43921,40999,35557,1163,266,3616,139,258,2922,0.433,0.117,0.369,11.7%,36.9%
0500000US53077,53077,53,77,"Yakima County, Washington",243231,109470,133761,129671,116024,1743,9072,2359,142,331,4090,0.568,0500000US53077,Yakima County,256728,130049,126679,118704,103578,1718,9357,2785,221,1045,7975,0.578,0.010,0.018,1.0%,1.8%
0500000US54001,54001,54,1,"Barbour County, West Virginia",16589,96,16493,16259,16005,120,91,34,3,6,234,0.069,0500000US54001,Barbour County,15465,192,15273,14717,14379,259,37,32,0,10,556,0.134,0.065,0.943,6.5%,94.3%
0500000US54003,54003,54,3,"Berkeley County, West Virginia",104169,3961,100208,97846,89379,7234,242,860,29,102,2362,0.257,0500000US54003,Berkeley County,122076,6893,115183,107960,96559,9118,284,1445,43,511,7223,0.362,0.105,0.409,10.5%,40.9%
0500000US54005,54005,54,5,"Boone County, West Virginia",24629,97,24532,24402,24220,122,33,21,1,5,130,0.033,0500000US54005,Boone County,21809,133,21676,20942,20712,135,39,36,2,18,734,0.097,0.064,1.947,6.4%,194.7%
0500000US54007,54007,54,7,"Braxton County, West Virginia",14523,67,14456,14335,14206,59,38,24,3,5,121,0.043,0500000US54007,Braxton County,12447,85,12362,12057,11939,50,19,23,11,15,305,0.079,0.036,0.841,3.6%,84.1%
0500000US54009,54009,54,9,"Brooke County, West Virginia",24069,163,23906,23647,23241,273,19,95,3,16,259,0.067,0500000US54009,Brooke County,22559,287,22272,21318,20792,365,36,55,0,70,954,0.148,0.081,1.203,8.1%,120.3%
0500000US54011,54011,54,11,"Cabell County, West Virginia",96319,1046,95273,93475,87520,4717,209,931,21,77,1798,0.171,0500000US54011,Cabell County,94350,1562,92788,88677,82095,4751,185,1328,20,298,4111,0.238,0.067,0.389,6.7%,38.9%
0500000US54013,54013,54,13,"Calhoun County, West Virginia",7627,57,7570,7517,7465,15,21,12,3,1,53,0.042,0500000US54013,Calhoun County,6229,48,6181,6017,5976,13,12,12,2,2,164,0.079,0.037,0.881,3.7%,88.1%
0500000US54015,54015,54,15,"Clay County, West Virginia",9386,33,9353,9280,9243,6,19,7,2,3,73,0.030,0500000US54015,Clay County,8051,52,7999,7705,7651,11,29,13,0,1,294,0.096,0.065,2.167,6.5%,216.7%
0500000US54017,54017,54,17,"Doddridge County, West Virginia",8202,39,8163,8077,7926,111,24,14,1,1,86,0.066,0500000US54017,Doddridge County,7808,77,7731,7509,7290,174,15,15,0,15,222,0.127,0.061,0.927,6.1%,92.7%
0500000US54019,54019,54,19,"Fayette County, West Virginia",46039,402,45637,45064,42763,2097,91,89,5,19,573,0.135,0500000US54019,Fayette County,40488,525,39963,38290,36308,1662,100,105,1,114,1673,0.192,0.057,0.425,5.7%,42.5%
0500000US54021,54021,54,21,"Gilmer County, West Virginia",8693,493,8200,8078,6952,1048,28,34,11,5,122,0.342,0500000US54021,Gilmer County,7408,244,7164,6991,6026,923,11,30,0,1,173,0.321,-0.021,-0.062,-2.1%,-6.2%
0500000US54023,54023,54,23,"Grant County, West Virginia",11937,120,11817,11731,11618,72,17,18,2,4,86,0.053,0500000US54023,Grant County,10976,91,10885,10611,10463,83,21,24,0,20,274,0.091,0.038,0.723,3.8%,72.3%
0500000US54025,54025,54,25,"Greenbrier County, West Virginia",35480,422,35058,34561,33330,973,88,142,8,20,497,0.116,0500000US54025,Greenbrier County,32977,571,32406,31305,30199,766,55,192,5,88,1101,0.159,0.043,0.369,4.3%,36.9%
0500000US54027,54027,54,27,"Hampshire County, West Virginia",23964,242,23722,23490,23146,225,49,50,15,5,232,0.067,0500000US54027,Hampshire County,23093,337,22756,22002,21655,178,30,61,4,74,754,0.119,0.052,0.786,5.2%,78.6%
0500000US54029,54029,54,29,"Hancock County, West Virginia",30676,314,30362,29989,29143,708,33,80,7,18,373,0.097,0500000US54029,Hancock County,29095,424,28671,27402,26484,695,31,110,8,74,1269,0.169,0.072,0.746,7.2%,74.6%
0500000US54031,54031,54,31,"Hardy County, West Virginia",14025,478,13547,13439,12936,327,24,142,0,10,108,0.147,0500000US54031,Hardy County,14299,659,13640,13188,12685,403,16,53,0,31,452,0.209,0.062,0.418,6.2%,41.8%
0500000US54033,54033,54,33,"Harrison County, West Virginia",69099,883,68216,67232,65629,1111,127,320,15,30,984,0.097,0500000US54033,Harrison County,65921,1403,64518,61770,59862,1104,135,489,28,152,2748,0.173,0.076,0.777,7.6%,77.7%
0500000US54035,54035,54,35,"Jackson County, West Virginia",29211,185,29026,28775,28563,78,41,79,9,5,251,0.044,0500000US54035,Jackson County,27791,230,27561,26709,26411,100,43,91,2,62,852,0.096,0.052,1.190,5.2%,119.0%
0500000US54037,54037,54,37,"Jefferson County, West Virginia",53498,2489,51009,49838,45565,3445,115,605,30,78,1171,0.268,0500000US54037,Jefferson County,57701,4137,53564,50398,45784,3379,104,817,10,304,3166,0.359,0.091,0.340,9.1%,34.0%
0500000US54039,54039,54,39,"Kanawha County, West Virginia",193063,1812,191251,187533,170969,13950,388,1982,37,207,3718,0.210,0500000US54039,Kanawha County,180745,2720,178025,169426,152735,13416,357,2138,47,733,8599,0.278,0.068,0.323,6.8%,32.3%
0500000US54041,54041,54,41,"Lewis County, West Virginia",16372,104,16268,16120,15964,65,32,51,1,7,148,0.049,0500000US54041,Lewis County,17033,191,16842,16261,16088,66,19,58,7,23,581,0.107,0.057,1.172,5.7%,117.2%
0500000US54043,54043,54,43,"Lincoln County, West Virginia",21720,96,21624,21496,21433,18,18,24,0,3,128,0.026,0500000US54043,Lincoln County,20463,171,20292,19815,19702,44,22,26,0,21,477,0.072,0.046,1.763,4.6%,176.3%
0500000US54045,54045,54,45,"Logan County, West Virginia",36743,258,36485,36211,35285,780,30,101,0,15,274,0.077,0500000US54045,Logan County,32567,224,32343,31504,30785,580,41,63,1,34,839,0.105,0.028,0.365,2.8%,36.5%
0500000US54047,54047,54,47,"McDowell County, West Virginia",22113,91,22022,21791,19637,2098,34,15,0,7,231,0.202,0500000US54047,McDowell County,19111,390,18721,18099,15871,2139,20,20,4,45,622,0.296,0.094,0.465,9.4%,46.5%
0500000US54049,54049,54,49,"Marion County, West Virginia",56418,514,55904,55142,52874,1838,101,281,5,43,762,0.120,0500000US54049,Marion County,56205,875,55330,52601,50223,1844,119,256,43,116,2729,0.198,0.077,0.644,7.7%,64.4%
0500000US54051,54051,54,51,"Marshall County, West Virginia",33107,265,32842,32589,32243,175,43,117,2,9,253,0.051,0500000US54051,Marshall County,30591,354,30237,29142,28669,260,34,108,7,64,1095,0.120,0.069,1.341,6.9%,134.1%
0500000US54053,54053,54,53,"Mason County, West Virginia",27324,119,27205,26939,26618,171,39,89,12,10,266,0.051,0500000US54053,Mason County,25453,170,25283,24646,24322,193,32,74,5,20,637,0.086,0.035,0.695,3.5%,69.5%
0500000US54055,54055,54,55,"Mercer County, West Virginia",62264,480,61784,60949,56711,3740,135,323,2,38,835,0.167,0500000US54055,Mercer County,59664,705,58959,56554,52264,3694,159,292,6,139,2405,0.227,0.061,0.363,6.1%,36.3%
0500000US54057,54057,54,57,"Mineral County, West Virginia",28212,202,28010,27672,26742,769,34,110,1,16,338,0.101,0500000US54057,Mineral County,26938,309,26629,25518,24603,711,36,113,5,50,1111,0.163,0.063,0.624,6.3%,62.4%
0500000US54059,54059,54,59,"Mingo County, West Virginia",26839,119,26720,26481,25944,471,18,43,0,5,239,0.065,0500000US54059,Mingo County,23568,164,23404,22796,22293,405,33,32,0,33,608,0.104,0.039,0.600,3.9%,60.0%
0500000US54061,54061,54,61,"Monongalia County, West Virginia",96189,1692,94497,92930,86298,3436,132,2929,42,93,1567,0.192,0500000US54061,Monongalia County,105822,3308,102514,97348,88959,4068,147,3729,63,382,5166,0.287,0.095,0.494,9.5%,49.4%
0500000US54063,54063,54,63,"Monroe County, West Virginia",13502,83,13419,13253,13110,89,26,15,3,10,166,0.057,0500000US54063,Monroe County,12376,94,12282,11919,11739,113,26,11,0,30,363,0.099,0.042,0.742,4.2%,74.2%
0500000US54065,54065,54,65,"Morgan County, West Virginia",17541,183,17358,17152,16949,96,43,50,4,10,206,0.066,0500000US54065,Morgan County,17063,236,16827,16170,15896,108,30,83,0,53,657,0.130,0.064,0.973,6.4%,97.3%
0500000US54067,54067,54,67,"Nicholas County, West Virginia",26233,146,26087,25858,25688,42,51,69,6,2,229,0.041,0500000US54067,Nicholas County,24604,173,24431,23719,23525,56,44,72,7,15,712,0.085,0.044,1.070,4.4%,107.0%
0500000US54069,54069,54,69,"Ohio County, West Virginia",44443,362,44081,43252,41163,1614,56,365,5,49,829,0.140,0500000US54069,Ohio County,42425,647,41778,39823,37559,1656,67,387,20,134,1955,0.212,0.072,0.512,7.2%,51.2%
0500000US54071,54071,54,71,"Pendleton County, West Virginia",7695,71,7624,7538,7353,149,15,20,1,0,86,0.086,0500000US54071,Pendleton County,6143,57,6086,5938,5835,81,7,0,2,13,148,0.097,0.011,0.123,1.1%,12.3%
0500000US54073,54073,54,73,"Pleasants County, West Virginia",7605,61,7544,7477,7354,96,11,8,0,8,67,0.065,0500000US54073,Pleasants County,7653,63,7590,7359,7215,95,22,17,0,10,231,0.110,0.045,0.703,4.5%,70.3%
0500000US54075,54075,54,75,"Pocahontas County, West Virginia",8719,68,8651,8564,8480,58,17,4,1,4,87,0.054,0500000US54075,Pocahontas County,7869,107,7762,7563,7455,51,23,9,0,25,199,0.102,0.048,0.886,4.8%,88.6%
0500000US54077,54077,54,77,"Preston County, West Virginia",33520,229,33291,33049,32557,360,61,48,10,13,242,0.056,0500000US54077,Preston County,34216,695,33521,32513,30348,2001,69,53,5,37,1008,0.209,0.152,2.698,15.2%,269.8%
0500000US54079,54079,54,79,"Putnam County, West Virginia",55486,484,55002,54440,53377,478,115,409,24,37,562,0.074,0500000US54079,Putnam County,57440,811,56629,54602,53139,646,81,577,7,152,2027,0.142,0.068,0.918,6.8%,91.8%
0500000US54081,54081,54,81,"Raleigh County, West Virginia",78859,996,77863,76615,69246,6390,180,715,23,61,1248,0.222,0500000US54081,Raleigh County,74591,1197,73394,70423,63510,5790,132,819,16,156,2971,0.267,0.045,0.204,4.5%,20.4%
0500000US54083,54083,54,83,"Randolph County, West Virginia",29405,192,29213,28993,28474,343,63,99,0,14,220,0.062,0500000US54083,Randolph County,27932,312,27620,26695,26033,424,56,96,1,85,925,0.130,0.068,1.092,6.8%,109.2%
0500000US54085,54085,54,85,"Ritchie County, West Virginia",10449,55,10394,10323,10275,20,11,10,0,7,71,0.033,0500000US54085,Ritchie County,8444,80,8364,8172,8116,16,6,19,7,8,192,0.076,0.043,1.293,4.3%,129.3%
0500000US54087,54087,54,87,"Roane County, West Virginia",14926,103,14823,14699,14613,19,25,38,1,3,124,0.041,0500000US54087,Roane County,14028,152,13876,13341,13231,35,28,38,0,9,535,0.109,0.067,1.630,6.7%,163.0%
0500000US54089,54089,54,89,"Summers County, West Virginia",13927,189,13738,13560,12837,645,38,28,0,12,178,0.148,0500000US54089,Summers County,11959,185,11774,11310,10823,400,33,33,0,21,464,0.178,0.030,0.204,3.0%,20.4%
0500000US54091,54091,54,91,"Taylor County, West Virginia",16895,143,16752,16602,16377,125,37,60,0,3,150,0.060,0500000US54091,Taylor County,16705,179,16526,15830,15636,112,19,41,0,22,696,0.122,0.062,1.028,6.2%,102.8%
0500000US54093,54093,54,93,"Tucker County, West Virginia",7141,41,7100,7058,7024,11,11,8,1,3,42,0.032,0500000US54093,Tucker County,6762,56,6706,6473,6432,20,4,6,1,10,233,0.094,0.062,1.897,6.2%,189.7%
0500000US54095,54095,54,95,"Tyler County, West Virginia",9208,49,9159,9113,9071,13,16,12,0,1,46,0.029,0500000US54095,Tyler County,8313,53,8260,7999,7964,4,15,3,0,13,261,0.081,0.052,1.754,5.2%,175.4%
0500000US54097,54097,54,97,"Upshur County, West Virginia",24254,250,24004,23783,23494,145,51,85,1,7,221,0.061,0500000US54097,Upshur County,23816,316,23500,22717,22349,211,37,87,5,28,783,0.118,0.057,0.921,5.7%,92.1%
0500000US54099,54099,54,99,"Wayne County, West Virginia",42481,218,42263,41968,41706,74,106,72,4,6,295,0.036,0500000US54099,Wayne County,38982,319,38663,37569,37199,168,53,83,10,56,1094,0.089,0.052,1.454,5.2%,145.4%
0500000US54101,54101,54,101,"Webster County, West Virginia",9154,48,9106,9016,8989,14,6,5,1,1,90,0.036,0500000US54101,Webster County,8378,50,8328,8123,8086,10,14,4,2,7,205,0.068,0.032,0.906,3.2%,90.6%
0500000US54103,54103,54,103,"Wetzel County, West Virginia",16583,83,16500,16399,16319,24,12,40,1,3,101,0.032,0500000US54103,Wetzel County,14442,148,14294,13817,13704,34,18,50,0,11,477,0.098,0.067,2.121,6.7%,212.1%
0500000US54105,54105,54,105,"Wirt County, West Virginia",5717,26,5691,5642,5610,9,12,10,1,0,49,0.037,0500000US54105,Wirt County,5194,22,5172,5021,4999,6,4,0,4,8,151,0.073,0.036,0.969,3.6%,96.9%
0500000US54107,54107,54,107,"Wood County, West Virginia",86956,744,86212,85042,83352,940,184,468,28,70,1170,0.081,0500000US54107,Wood County,84296,1174,83122,79672,77718,1016,148,564,17,209,3450,0.148,0.067,0.831,6.7%,83.1%
0500000US54109,54109,54,109,"Wyoming County, West Virginia",23796,105,23691,23451,23270,116,33,25,2,5,240,0.044,0500000US54109,Wyoming County,21382,170,21212,20708,20539,107,30,11,1,20,504,0.077,0.033,0.759,3.3%,75.9%
0500000US55001,55001,55,1,"Adams County, Wisconsin",20875,783,20092,19892,19013,611,179,80,4,5,200,0.168,0500000US55001,Adams County,20654,797,19857,19282,18372,593,165,84,8,60,575,0.206,0.038,0.224,3.8%,22.4%
0500000US55003,55003,55,3,"Ashland County, Wisconsin",16157,302,15855,15363,13534,47,1713,58,4,7,492,0.286,0500000US55003,Ashland County,16027,383,15644,14902,12678,112,1999,82,9,22,742,0.356,0.070,0.245,7.0%,24.5%
0500000US55005,55005,55,5,"Barron County, Wisconsin",45870,862,45008,44577,43567,397,380,220,3,10,431,0.097,0500000US55005,Barron County,46711,1277,45434,43908,42210,813,436,345,5,99,1526,0.181,0.084,0.862,8.4%,86.2%
0500000US55007,55007,55,7,"Bayfield County, Wisconsin",15014,158,14856,14448,12955,44,1393,48,1,7,408,0.246,0500000US55007,Bayfield County,16220,279,15941,15205,13445,54,1612,36,2,56,736,0.301,0.055,0.222,5.5%,22.2%
0500000US55009,55009,55,9,"Brown County, Wisconsin",248007,17985,230022,225876,207702,5286,5968,6657,88,175,4146,0.291,0500000US55009,Brown County,268740,26216,242524,232119,208440,8154,6329,8445,114,637,10405,0.385,0.094,0.321,9.4%,32.1%
0500000US55011,55011,55,11,"Buffalo County, Wisconsin",13587,237,13350,13260,13135,35,37,27,0,26,90,0.065,0500000US55011,Buffalo County,13317,327,12990,12690,12577,43,31,19,12,8,300,0.107,0.042,0.643,4.2%,64.3%
0500000US55013,55013,55,13,"Burnett County, Wisconsin",15457,194,15263,14913,14067,81,704,52,3,6,350,0.169,0500000US55013,Burnett County,16526,254,16272,15515,14658,65,697,53,10,32,757,0.209,0.040,0.238,4.0%,23.8%
0500000US55015,55015,55,15,"Calumet County, Wisconsin",48971,1690,47281,46805,45325,236,179,1027,14,24,476,0.142,0500000US55015,Calumet County,52442,2857,49585,48099,46056,419,189,1269,42,124,1486,0.224,0.083,0.584,8.3%,58.4%
0500000US55017,55017,55,17,"Chippewa County, Wisconsin",62415,800,61615,61058,59028,961,272,770,11,16,557,0.105,0500000US55017,Chippewa County,66297,1257,65040,62880,60391,1040,323,959,14,153,2160,0.168,0.063,0.604,6.3%,60.4%
0500000US55019,55019,55,19,"Clark County, Wisconsin",34690,1292,33398,33242,32865,73,163,127,7,7,156,0.101,0500000US55019,Clark County,34659,2098,32561,31968,31566,103,117,106,4,72,593,0.167,0.066,0.649,6.6%,64.9%
0500000US55021,55021,55,21,"Columbia County, Wisconsin",56833,1444,55389,54895,53628,697,233,298,24,15,494,0.109,0500000US55021,Columbia County,58490,2139,56351,54682,53037,866,270,376,11,122,1669,0.175,0.067,0.613,6.7%,61.3%
0500000US55023,55023,55,23,"Crawford County, Wisconsin",16644,150,16494,16384,15991,288,36,63,3,3,110,0.076,0500000US55023,Crawford County,16113,260,15853,15427,15018,265,41,68,1,34,426,0.130,0.054,0.700,5.4%,70.0%
0500000US55025,55025,55,25,"Dane County, Wisconsin",488073,28925,459148,449219,399488,24717,1338,22903,145,628,9929,0.321,0500000US55025,Dane County,561504,41954,519550,495647,426721,29742,1275,35592,214,2103,23903,0.408,0.087,0.270,8.7%,27.0%
0500000US55027,55027,55,27,"Dodge County, Wisconsin",88759,3522,85237,84577,81325,2361,369,460,39,23,660,0.158,0500000US55027,Dodge County,89396,5490,83906,81643,77845,2701,371,511,11,204,2263,0.236,0.078,0.495,7.8%,49.5%
0500000US55029,55029,55,29,"Door County, Wisconsin",27785,671,27114,26887,26483,139,142,112,4,7,227,0.091,0500000US55029,Door County,30066,1138,28928,27998,27524,140,122,136,0,76,930,0.159,0.069,0.756,6.9%,75.6%
0500000US55031,55031,55,31,"Douglas County, Wisconsin",44159,494,43665,42563,40854,475,838,370,7,19,1102,0.143,0500000US55031,Douglas County,44295,768,43527,41199,39417,576,763,286,18,139,2328,0.205,0.062,0.432,6.2%,43.2%
0500000US55033,55033,55,33,"Dunn County, Wisconsin",43857,626,43231,42761,41225,215,152,1141,15,13,470,0.115,0500000US55033,Dunn County,45440,1035,44405,43009,40912,388,157,1451,13,88,1396,0.187,0.071,0.619,7.1%,61.9%
0500000US55035,55035,55,35,"Eau Claire County, Wisconsin",98736,1804,96932,95541,90918,837,430,3276,30,50,1391,0.150,0500000US55035,Eau Claire County,105710,3118,102592,98706,92354,1213,440,4365,83,251,3886,0.233,0.082,0.547,8.2%,54.7%
0500000US55037,55037,55,37,"Florence County, Wisconsin",4423,37,4386,4341,4287,10,30,13,1,0,45,0.060,0500000US55037,Florence County,4558,66,4492,4355,4296,9,30,5,4,11,137,0.110,0.050,0.832,5.0%,83.2%
0500000US55039,55039,55,39,"Fond du Lac County, Wisconsin",101633,4368,97265,96236,93398,1226,422,1129,16,45,1029,0.153,0500000US55039,Fond du Lac County,104154,6717,97437,94312,90150,2321,355,1241,31,214,3125,0.245,0.092,0.599,9.2%,59.9%
0500000US55041,55041,55,41,"Forest County, Wisconsin",9304,138,9166,8957,7646,71,1213,12,11,4,209,0.307,0500000US55041,Forest County,9179,155,9024,8617,7371,32,1187,17,7,3,407,0.336,0.029,0.095,2.9%,9.5%
0500000US55043,55043,55,43,"Grant County, Wisconsin",51208,649,50559,50271,49296,573,89,300,4,9,288,0.073,0500000US55043,Grant County,51938,1236,50702,49576,48325,679,95,411,8,58,1126,0.133,0.060,0.824,6.0%,82.4%
0500000US55045,55045,55,45,"Green County, Wisconsin",36842,1033,35809,35521,35113,137,50,197,9,15,288,0.091,0500000US55045,Green County,37093,1500,35593,34459,33960,201,49,170,3,76,1134,0.159,0.068,0.754,6.8%,75.4%
0500000US55047,55047,55,47,"Green Lake County, Wisconsin",19051,743,18308,18211,17990,79,46,85,5,6,97,0.107,0500000US55047,Green Lake County,19018,979,18039,17550,17255,106,49,101,0,39,489,0.173,0.067,0.625,6.7%,62.5%
0500000US55049,55049,55,49,"Iowa County, Wisconsin",23687,336,23351,23166,22904,86,35,124,5,12,185,0.065,0500000US55049,Iowa County,23709,455,23254,22583,22203,114,26,178,12,50,671,0.122,0.057,0.881,5.7%,88.1%
0500000US55051,55051,55,51,"Iron County, Wisconsin",5916,35,5881,5826,5772,3,33,18,0,0,55,0.048,0500000US55051,Iron County,6137,72,6065,5923,5809,11,63,13,0,27,142,0.103,0.055,1.154,5.5%,115.4%
0500000US55053,55053,55,53,"Jackson County, Wisconsin",20449,519,19930,19667,17987,390,1211,51,19,9,263,0.222,0500000US55053,Jackson County,21145,678,20467,19816,17939,440,1319,73,0,45,651,0.274,0.052,0.236,5.2%,23.6%
0500000US55055,55055,55,55,"Jefferson County, Wisconsin",83686,5555,78131,77364,75903,628,212,551,13,57,767,0.173,0500000US55055,Jefferson County,84900,7068,77832,75262,73325,864,206,646,19,202,2570,0.246,0.073,0.424,7.3%,42.4%
0500000US55057,55057,55,57,"Juneau County, Wisconsin",26664,687,25977,25738,24706,545,361,113,4,9,239,0.140,0500000US55057,Juneau County,26718,727,25991,25111,24008,548,355,147,1,52,880,0.190,0.050,0.357,5.0%,35.7%
0500000US55059,55059,55,59,"Kenosha County, Wisconsin",166426,19592,146834,143647,129892,10655,513,2343,67,177,3187,0.372,0500000US55059,Kenosha County,169151,24546,144605,137175,121936,11480,371,2793,67,528,7430,0.452,0.080,0.215,8.0%,21.5%
0500000US55061,55061,55,61,"Kewaunee County, Wisconsin",20574,463,20111,19941,19724,63,75,59,5,15,170,0.080,0500000US55061,Kewaunee County,20563,834,19729,19211,18992,57,55,64,2,41,518,0.145,0.064,0.801,6.4%,80.1%
0500000US55063,55063,55,63,"La Crosse County, Wisconsin",114638,1741,112897,111247,104417,1553,438,4727,27,85,1650,0.168,0500000US55063,La Crosse County,120784,3051,117733,113674,105307,1927,440,5599,16,385,4059,0.236,0.068,0.402,6.8%,40.2%
0500000US55065,55065,55,65,"Lafayette County, Wisconsin",16836,522,16314,16234,16102,39,36,57,0,0,80,0.084,0500000US55065,Lafayette County,16611,1089,15522,15187,15081,27,20,36,4,19,335,0.171,0.087,1.029,8.7%,102.9%
0500000US55067,55067,55,67,"Langlade County, Wisconsin",19977,324,19653,19418,19109,70,172,62,0,5,235,0.085,0500000US55067,Langlade County,19491,459,19032,18407,17960,105,235,67,4,36,625,0.149,0.065,0.765,6.5%,76.5%
0500000US55069,55069,55,69,"Lincoln County, Wisconsin",28743,340,28403,28152,27763,152,89,124,10,14,251,0.067,0500000US55069,Lincoln County,28415,529,27886,27144,26734,148,108,117,2,35,742,0.114,0.047,0.704,4.7%,70.4%
0500000US55071,55071,55,71,"Manitowoc County, Wisconsin",81442,2565,78877,78105,75210,412,395,2027,10,51,772,0.145,0500000US55071,Manitowoc County,81359,4050,77309,74823,70951,1027,371,2247,15,212,2486,0.235,0.090,0.617,9.0%,61.7%
0500000US55073,55073,55,73,"Marathon County, Wisconsin",134063,2992,131071,129590,121007,820,566,7107,25,65,1481,0.182,0500000US55073,Marathon County,138013,4453,133560,129270,118783,1141,546,8431,29,340,4290,0.253,0.072,0.394,7.2%,39.4%
0500000US55075,55075,55,75,"Marinette County, Wisconsin",41749,522,41227,40827,40260,106,216,217,8,20,400,0.070,0500000US55075,Marinette County,41872,1079,40793,39433,38754,192,203,180,8,96,1360,0.142,0.072,1.030,7.2%,103.0%
0500000US55077,55077,55,77,"Marquette County, Wisconsin",15404,391,15013,14925,14697,75,81,68,0,4,88,0.089,0500000US55077,Marquette County,15592,488,15104,14682,14477,44,60,51,5,45,422,0.136,0.047,0.531,4.7%,53.1%
0500000US55078,55078,55,78,"Menominee County, Wisconsin",4232,178,4054,4005,447,19,3538,1,0,0,49,0.288,0500000US55078,Menominee County,4255,136,4119,4038,483,2,3549,2,2,0,81,0.290,0.002,0.007,0.2%,0.7%
0500000US55079,55079,55,79,"Milwaukee County, Wisconsin",947735,126039,821696,802406,514958,248794,5212,32007,296,1139,19290,0.617,0500000US55079,Milwaukee County,939489,153017,786472,751292,456520,240416,3878,45989,262,4227,35180,0.668,0.051,0.083,5.1%,8.3%
0500000US55081,55081,55,81,"Monroe County, Wisconsin",44673,1661,43012,42535,41260,475,464,281,40,15,477,0.145,0500000US55081,Monroe County,46274,2560,43714,42247,40608,620,493,352,63,111,1467,0.225,0.080,0.553,8.0%,55.3%
0500000US55083,55083,55,83,"Oconto County, Wisconsin",37660,519,37141,36802,36167,68,443,110,3,11,339,0.077,0500000US55083,Oconto County,38965,848,38117,36900,36170,91,463,110,0,66,1217,0.137,0.059,0.769,5.9%,76.9%
0500000US55085,55085,55,85,"Oneida County, Wisconsin",35998,385,35613,35200,34560,150,295,188,5,2,413,0.078,0500000US55085,Oneida County,37845,575,37270,36240,35264,205,441,195,18,117,1030,0.131,0.053,0.675,5.3%,67.5%
0500000US55087,55087,55,87,"Outagamie County, Wisconsin",176695,6359,170336,168126,158366,1682,2719,5208,55,96,2210,0.194,0500000US55087,Outagamie County,190705,9423,181282,174666,161879,2929,2743,6588,112,415,6616,0.274,0.080,0.413,8.0%,41.3%
0500000US55089,55089,55,89,"Ozaukee County, Wisconsin",86395,1956,84439,83586,80689,1144,174,1505,20,54,853,0.127,0500000US55089,Ozaukee County,91503,3098,88405,85700,81410,1483,167,2283,14,343,2705,0.206,0.079,0.623,7.9%,62.3%
0500000US55091,55091,55,91,"Pepin County, Wisconsin",7469,72,7397,7358,7305,18,17,13,1,4,39,0.043,0500000US55091,Pepin County,7318,157,7161,6948,6866,20,33,22,0,7,213,0.118,0.075,1.734,7.5%,173.4%
0500000US55093,55093,55,93,"Pierce County, Wisconsin",41019,623,40396,39956,39264,223,141,299,5,24,440,0.083,0500000US55093,Pierce County,42212,1220,40992,39584,38535,402,209,289,10,139,1408,0.165,0.081,0.975,8.1%,97.5%
0500000US55095,55095,55,95,"Polk County, Wisconsin",44205,656,43549,43162,42475,91,424,148,6,18,387,0.076,0500000US55095,Polk County,44977,947,44030,42643,41772,159,370,205,7,130,1387,0.136,0.060,0.781,6.0%,78.1%
0500000US55097,55097,55,97,"Portage County, Wisconsin",70019,1853,68166,67483,64897,362,222,1955,12,35,683,0.139,0500000US55097,Portage County,70377,2620,67757,65767,62212,903,242,2252,16,142,1990,0.215,0.076,0.544,7.6%,54.4%
0500000US55099,55099,55,99,"Price County, Wisconsin",14159,153,14006,13874,13661,34,50,58,64,7,132,0.069,0500000US55099,Price County,14054,180,13874,13500,13157,31,83,67,124,38,374,0.123,0.054,0.780,5.4%,78.0%
0500000US55101,55101,55,101,"Racine County, Wisconsin",195408,22546,172862,169589,145414,21212,614,2081,40,228,3273,0.421,0500000US55101,Racine County,197727,27911,169816,161502,135333,22531,538,2261,47,792,8314,0.497,0.076,0.181,7.6%,18.1%
0500000US55103,55103,55,103,"Richland County, Wisconsin",18021,360,17661,17540,17315,79,44,88,4,10,121,0.076,0500000US55103,Richland County,17304,526,16778,16267,16014,92,42,95,0,24,511,0.142,0.065,0.856,6.5%,85.6%
0500000US55105,55105,55,105,"Rock County, Wisconsin",160331,12124,148207,145438,135526,7766,383,1603,35,125,2769,0.277,0500000US55105,Rock County,163687,15800,147887,140837,129796,8060,386,2022,50,523,7050,0.357,0.080,0.290,8.0%,29.0%
0500000US55107,55107,55,107,"Rusk County, Wisconsin",14755,173,14582,14454,14284,56,70,41,1,2,128,0.063,0500000US55107,Rusk County,14188,250,13938,13483,13287,44,58,53,5,36,455,0.122,0.059,0.943,5.9%,94.3%
0500000US55109,55109,55,109,"St. Croix County, Wisconsin",84345,1692,82653,81670,79895,542,284,894,16,39,983,0.102,0500000US55109,St. Croix County,93536,2679,90857,87651,85457,635,233,984,33,309,3206,0.163,0.061,0.599,6.1%,59.9%
0500000US55111,55111,55,111,"Sauk County, Wisconsin",61976,2675,59301,58726,57331,330,690,332,13,30,575,0.142,0500000US55111,Sauk County,65763,4050,61713,59767,57868,578,764,394,15,148,1946,0.221,0.079,0.553,7.9%,55.3%
0500000US55113,55113,55,113,"Sawyer County, Wisconsin",16557,268,16289,15800,13004,76,2669,49,0,2,489,0.356,0500000US55113,Sawyer County,18074,358,17716,16893,13817,96,2861,63,2,54,823,0.388,0.032,0.090,3.2%,9.0%
0500000US55115,55115,55,115,"Shawano County, Wisconsin",41949,905,41044,40307,36951,131,3025,180,12,8,737,0.218,0500000US55115,Shawano County,40881,1176,39705,38060,34404,117,3309,165,6,59,1645,0.283,0.065,0.296,6.5%,29.6%
0500000US55117,55117,55,117,"Sheboygan County, Wisconsin",115507,6329,109178,107889,100520,1605,392,5279,29,64,1289,0.237,0500000US55117,Sheboygan County,118034,8662,109372,105889,95837,2434,362,6875,21,360,3483,0.331,0.093,0.394,9.3%,39.4%
0500000US55119,55119,55,119,"Taylor County, Wisconsin",20689,316,20373,20268,20110,54,41,54,8,1,105,0.055,0500000US55119,Taylor County,19913,567,19346,18897,18713,64,39,62,5,14,449,0.116,0.061,1.104,6.1%,110.4%
0500000US55121,55121,55,121,"Trempealeau County, Wisconsin",28816,1667,27149,27007,26774,54,49,119,2,9,142,0.133,0500000US55121,Trempealeau County,30760,3957,26803,26154,25830,81,82,109,0,52,649,0.278,0.145,1.084,14.5%,108.4%
0500000US55123,55123,55,123,"Vernon County, Wisconsin",29773,394,29379,29142,28873,106,53,92,7,11,237,0.059,0500000US55123,Vernon County,30714,464,30250,29535,29179,121,41,89,9,96,715,0.097,0.037,0.630,3.7%,63.0%
0500000US55125,55125,55,125,"Vilas County, Wisconsin",21430,268,21162,20932,18546,31,2290,61,1,3,230,0.239,0500000US55125,Vilas County,23047,459,22588,21917,19569,49,2181,57,0,61,671,0.269,0.029,0.123,2.9%,12.3%
0500000US55127,55127,55,127,"Walworth County, Wisconsin",102228,10578,91650,90709,88690,904,196,819,33,67,941,0.236,0500000US55127,Walworth County,106478,12550,93928,90779,88104,1166,229,1002,10,268,3149,0.300,0.064,0.271,6.4%,27.1%
0500000US55129,55129,55,129,"Washburn County, Wisconsin",15911,208,15703,15490,15228,26,174,59,2,1,213,0.084,0500000US55129,Washburn County,16623,299,16324,15659,15348,30,182,59,4,36,665,0.145,0.062,0.741,6.2%,74.1%
0500000US55131,55131,55,131,"Washington County, Wisconsin",131887,3385,128502,127282,124348,1115,345,1401,22,51,1220,0.110,0500000US55131,Washington County,136761,4827,131934,128177,123855,1672,272,1943,28,407,3757,0.177,0.067,0.612,6.7%,61.2%
0500000US55133,55133,55,133,"Waukesha County, Wisconsin",389891,16123,373768,369747,353114,4726,863,10675,117,252,4021,0.177,0500000US55133,Waukesha County,406978,21835,385143,372252,347922,6648,807,15616,121,1138,12891,0.264,0.086,0.489,8.6%,48.9%
0500000US55135,55135,55,135,"Waupaca County, Wisconsin",52410,1307,51103,50747,50150,149,234,190,5,19,356,0.084,0500000US55135,Waupaca County,51812,1864,49948,48591,47784,202,242,254,4,105,1357,0.147,0.064,0.762,6.4%,76.2%
0500000US55137,55137,55,137,"Waushara County, Wisconsin",24496,1329,23167,22977,22317,445,107,90,10,8,190,0.167,0500000US55137,Waushara County,24520,1693,22827,22224,21552,389,121,98,14,50,603,0.222,0.055,0.331,5.5%,33.1%
0500000US55139,55139,55,139,"Winnebago County, Wisconsin",166994,5784,161210,159241,151509,2856,941,3795,52,88,1969,0.175,0500000US55139,Winnebago County,171730,8328,163402,157422,145581,4931,935,5560,53,362,5980,0.276,0.101,0.579,10.1%,57.9%
0500000US55141,55141,55,141,"Wood County, Wisconsin",74749,1680,73069,72439,70177,382,539,1304,8,29,630,0.118,0500000US55141,Wood County,74207,2376,71831,69752,67055,547,549,1382,29,190,2079,0.181,0.064,0.540,6.4%,54.0%
0500000US56001,56001,56,1,"Albany County, Wyoming",36299,3202,33097,32454,30796,390,198,1005,17,48,643,0.271,0500000US56001,Albany County,37066,3910,33156,31496,29584,384,282,1028,30,188,1660,0.349,0.078,0.286,7.8%,28.6%
0500000US56003,56003,56,3,"Big Horn County, Wyoming",11668,984,10684,10592,10435,25,89,37,2,4,92,0.193,0500000US56003,Big Horn County,11521,1069,10452,10098,9884,22,98,44,6,44,354,0.254,0.061,0.318,6.1%,31.8%
0500000US56005,56005,56,5,"Campbell County, Wyoming",46133,3611,42522,41873,41032,134,415,250,18,24,649,0.202,0500000US56005,Campbell County,47026,4283,42743,40862,39601,219,509,320,25,188,1881,0.281,0.078,0.387,7.8%,38.7%
0500000US56007,56007,56,7,"Carbon County, Wyoming",15885,2668,13217,13046,12683,109,121,103,13,17,171,0.334,0500000US56007,Carbon County,14537,2600,11937,11455,11006,130,155,89,15,60,482,0.393,0.059,0.178,5.9%,17.8%
0500000US56009,56009,56,9,"Converse County, Wyoming",13833,867,12966,12809,12632,43,88,41,1,4,157,0.162,0500000US56009,Converse County,13751,1062,12689,12203,11996,39,72,55,0,41,486,0.232,0.070,0.430,7.0%,43.0%
0500000US56011,56011,56,11,"Crook County, Wyoming",7083,141,6942,6868,6794,14,46,11,0,3,74,0.079,0500000US56011,Crook County,7181,112,7069,6841,6766,0,43,9,7,16,228,0.111,0.032,0.398,3.2%,39.8%
0500000US56013,56013,56,13,"Fremont County, Wyoming",40123,2264,37859,36970,28677,86,8025,151,7,24,889,0.445,0500000US56013,Fremont County,39234,2421,36813,34898,26586,166,7798,205,7,136,1915,0.495,0.050,0.111,5.0%,11.1%
0500000US56015,56015,56,15,"Goshen County, Wyoming",13249,1288,11961,11857,11651,70,91,32,10,3,104,0.217,0500000US56015,Goshen County,12498,1212,11286,10942,10695,76,83,46,0,42,344,0.257,0.040,0.186,4.0%,18.6%
0500000US56017,56017,56,17,"Hot Springs County, Wyoming",4812,105,4707,4647,4550,12,62,20,3,0,60,0.105,0500000US56017,Hot Springs County,4621,177,4444,4230,4142,9,42,18,3,16,214,0.193,0.088,0.835,8.8%,83.5%
0500000US56019,56019,56,19,"Johnson County, Wyoming",8569,276,8293,8220,8092,14,72,36,0,6,73,0.107,0500000US56019,Johnson County,8447,347,8100,7785,7640,26,69,15,7,28,315,0.179,0.072,0.670,7.2%,67.0%
0500000US56021,56021,56,21,"Laramie County, Wyoming",91738,11978,79760,77947,74120,2063,595,935,119,115,1813,0.329,0500000US56021,Laramie County,100512,15602,84910,79957,75279,2200,596,1228,136,518,4953,0.412,0.083,0.251,8.3%,25.1%
0500000US56023,56023,56,23,"Lincoln County, Wyoming",18106,781,17325,17158,16930,32,126,55,4,11,167,0.124,0500000US56023,Lincoln County,19581,959,18622,18080,17737,34,101,96,21,91,542,0.176,0.053,0.425,5.3%,42.5%
0500000US56025,56025,56,25,"Natrona County, Wyoming",75450,5231,70219,69002,67191,621,612,479,35,64,1217,0.202,0500000US56025,Natrona County,79955,7169,72786,69127,66614,729,767,633,78,306,3659,0.295,0.094,0.465,9.4%,46.5%
0500000US56027,56027,56,27,"Niobrara County, Wyoming",2484,52,2432,2396,2361,4,20,9,0,2,36,0.096,0500000US56027,Niobrara County,2467,76,2391,2305,2255,6,27,12,5,0,86,0.162,0.066,0.692,6.6%,69.2%
0500000US56029,56029,56,29,"Park County, Wyoming",28205,1365,26840,26490,26090,50,139,164,25,22,350,0.142,0500000US56029,Park County,29624,1697,27927,26871,26316,59,120,211,17,148,1056,0.206,0.064,0.454,6.4%,45.4%
0500000US56031,56031,56,31,"Platte County, Wyoming",8667,580,8087,8004,7908,25,29,31,5,6,83,0.163,0500000US56031,Platte County,8605,695,7910,7635,7469,19,67,43,4,33,275,0.239,0.076,0.467,7.6%,46.7%
0500000US56033,56033,56,33,"Sheridan County, Wyoming",29116,1013,28103,27751,27119,94,324,192,14,8,352,0.131,0500000US56033,Sheridan County,30921,1416,29505,28266,27509,110,324,180,17,126,1239,0.205,0.074,0.563,7.4%,56.3%
0500000US56035,56035,56,35,"Sublette County, Wyoming",10247,712,9535,9425,9260,30,79,51,1,4,110,0.178,0500000US56035,Sublette County,8728,636,8092,7813,7651,17,44,46,10,45,279,0.225,0.047,0.263,4.7%,26.3%
0500000US56037,56037,56,37,"Sweetwater County, Wyoming",43806,6689,37117,36559,35432,415,317,324,41,30,558,0.322,0500000US56037,Sweetwater County,42272,6957,35315,33463,32362,351,259,283,61,147,1852,0.385,0.063,0.194,6.3%,19.4%
0500000US56039,56039,56,39,"Teton County, Wyoming",21294,3191,18103,17893,17505,32,76,228,13,39,210,0.302,0500000US56039,Teton County,23331,3295,20036,19280,18754,49,66,309,3,99,756,0.333,0.031,0.103,3.1%,10.3%
0500000US56041,56041,56,41,"Uinta County, Wyoming",21118,1855,19263,18962,18696,48,123,59,34,2,301,0.208,0500000US56041,Uinta County,20450,1986,18464,17827,17444,50,122,108,27,76,637,0.262,0.054,0.258,5.4%,25.8%
0500000US56043,56043,56,43,"Washakie County, Wyoming",8533,1162,7371,7278,7158,22,51,46,1,0,93,0.278,0500000US56043,Washakie County,7685,1070,6615,6402,6268,12,45,33,1,43,213,0.315,0.037,0.133,3.7%,13.3%
0500000US56045,56045,56,45,"Weston County, Wyoming",7208,216,6992,6889,6762,18,86,20,2,1,103,0.119,0500000US56045,Weston County,6838,295,6543,6295,6106,28,92,26,9,34,248,0.199,0.081,0.679,8.1%,67.9%
,,,,,,,,,,,,,,,,,,,,,,,,,,,,,,,,,,
,,,,,,,,,,,,,,,,,,,,,,,,,,,,,,,,,,
